O.S.N.,Candidate,Party,EVM Votes,Postal Votes,Total Votes,% of Votes,Vidhan_Sabha_Name
1,JAT MAMAD JUNG,Indian National Congress,70423,341,70764,43.37,Gujarat-Abdasa -1
2,JADEJA PRADHYUMANSINH MAHIPATSINH,Bharatiya Janata Party,79298,897,80195,49.15,Gujarat-Abdasa -1
3,MEGHWAL NAGSHI KHAMUBHAI,Bahujan Samaj Party,1022,20,1042,0.64,Gujarat-Abdasa -1
4,K. D. JADEJA,Praja Vijay Paksh,299,5,304,0.19,Gujarat-Abdasa -1
5,JOSHI JAGDISHCHANDRA KAKULAL,Samajwadi Party,195,2,197,0.12,Gujarat-Abdasa -1
6,VASANTBHAI VALJI KHETANI,Aam Aadmi Party,1606,98,1704,1.04,Gujarat-Abdasa -1
7,MAMUBHAI MANDABHAI RABARI,Independent,1722,13,1735,1.06,Gujarat-Abdasa -1
8,UTHAR RAZAK ALIMAMAD,Independent,437,13,450,0.28,Gujarat-Abdasa -1
9,BHANUSHALI SURESH MANJI MANGE,Independent,337,0,337,0.21,Gujarat-Abdasa -1
10,HAKUMATSINH JUVANSINH JADEJA,Independent,3474,28,3502,2.15,Gujarat-Abdasa -1
11,NOTA,None of the Above,2925,17,2942,1.8,Gujarat-Abdasa -1
1,Aniruddha Bhailal Dave,Bharatiya Janata Party,89747,556,90303,53.3,Gujarat-Mandvi -2
2,Kishorbhai Dheda,Bahujan Samaj Party,1817,29,1846,1.09,Gujarat-Mandvi -2
3,Rajendrasinh A. Jadeja,Indian National Congress,41768,238,42006,24.79,Gujarat-Mandvi -2
4,Kailasdan K. Gadhvi,Aam Aadmi Party,22501,290,22791,13.45,Gujarat-Mandvi -2
5,Advocate Mahamadiqbal Manjaliya,All India Majlis-E-Ittehadul Muslimeen,8477,17,8494,5.01,Gujarat-Mandvi -2
6,Vachhiya Lakhmir Rabari,Praja Vijay Paksh,373,6,379,0.22,Gujarat-Mandvi -2
7,Sameja Abdulkarim Amad,Independent,660,3,663,0.39,Gujarat-Mandvi -2
8,Sangar  Shivji Budhiya,Independent,517,0,517,0.31,Gujarat-Mandvi -2
9,NOTA,None of the Above,2411,16,2427,1.43,Gujarat-Mandvi -2
1,ARJAN BHUDIA,Indian National Congress,36495,273,36768,20.4,Gujarat-Bhuj -3
2,KESHUBHAI SHIVDAS PATEL,Bharatiya Janata Party,95746,836,96582,53.59,Gujarat-Bhuj -3
3,SAIYAD JUSABSHA MAMADSHA,Bahujan Samaj Party,1032,11,1043,0.58,Gujarat-Bhuj -3
4,NODE KASAM MOHAMAD,Right to Recall Party,445,3,448,0.25,Gujarat-Bhuj -3
5,MEHULRAJ BHARATSINH RATHOD,Praja Vijay Paksh,435,4,439,0.24,Gujarat-Bhuj -3
6,RAJESH KESARA PINDORIA,Aam Aadmi Party,7840,220,8060,4.47,Gujarat-Bhuj -3
7,SAKIL MAHAMAD SAMA,All India Majlis-E-Ittehadul Muslimeen,31249,46,31295,17.36,Gujarat-Bhuj -3
8,OSMAN ISHABHAI KUMBHAR,Independent,541,4,545,0.3,Gujarat-Bhuj -3
9,THEBA HUSEN MAMAD,Independent,467,0,467,0.26,Gujarat-Bhuj -3
10,BHUPENDRA BABULAL JOSHI,Independent,1113,3,1116,0.62,Gujarat-Bhuj -3
11,NOTA,None of the Above,3425,37,3462,1.92,Gujarat-Bhuj -3
1,CHAVDA SUDHA BAKUL,Bahujan Samaj Party,2349,10,2359,1.35,Gujarat-Anjar -4
2,CHHANGA TRIKAM BIJAL,Bharatiya Janata Party,98606,470,99076,56.52,Gujarat-Anjar -4
3,DANGAR RAMESHBHAI SHAMJIBHAI,Indian National Congress,61084,283,61367,35.01,Gujarat-Anjar -4
4,ARJANBHAI CHANABHAI RABARI,Aam Aadmi Party,7220,115,7335,4.18,Gujarat-Anjar -4
5,KAKAL GANIBHAI ADAMBHAI,Gujarat Sarva Samaj Party,638,0,638,0.36,Gujarat-Anjar -4
6,ROSHANALI IBRAHIM SANDHANI,SOCIAL DEMOCRATIC PARTY OF INDIA,955,2,957,0.55,Gujarat-Anjar -4
7,RAMESH JAKHARABHAI KODECHA,Independent,1061,1,1062,0.61,Gujarat-Anjar -4
8,NOTA,None of the Above,2467,18,2485,1.42,Gujarat-Anjar -4
1,BHARATBHAI VELJIBHAI SOLANKI,Indian National Congress,45729,200,45929,30.28,Gujarat-Gandhidham -5
2,MALTI KISHOR MAHESHWARI,Bharatiya Janata Party,83382,378,83760,55.23,Gujarat-Gandhidham -5
3,MAURYA K. D.,Bahujan Samaj Party,1002,8,1010,0.67,Gujarat-Gandhidham -5
4,ARVIND ASHOK SANGHELA,Gujarat Sarva Samaj Party,428,1,429,0.28,Gujarat-Gandhidham -5
5,BUDHABHAI THAVAR MAHESHWARI,Aam Aadmi Party,14655,172,14827,9.78,Gujarat-Gandhidham -5
6,MAHESHWARI VANITA DAHYALAL,Sanyukt Vikas Party,285,0,285,0.19,Gujarat-Gandhidham -5
7,LALJIBHAI KARABHAI BALIYA,Samajwadi Party,968,0,968,0.64,Gujarat-Gandhidham -5
8,SAMIRBHAI JUMABHAI MAHESHWARI,Independent,558,1,559,0.37,Gujarat-Gandhidham -5
9,SONDARVA JIGNASHA MAHESHBHAI,Independent,787,6,793,0.52,Gujarat-Gandhidham -5
10,NOTA,None of the Above,3087,18,3105,2.05,Gujarat-Gandhidham -5
1,BHACHUBHAI DHARAMSHI AARETHIYA,Indian National Congress,66106,278,66384,45.77,Gujarat-Rapar -6
2,VIRENDRASINH BAHADURSINH JADEJA,Bharatiya Janata Party,66589,372,66961,46.17,Gujarat-Rapar -6
3,AMBA PARAVANT PATEL,Aam Aadmi Party,2387,47,2434,1.68,Gujarat-Rapar -6
4,MANSUKH VAJERAM MAKVANA,Gujarat Sarva Samaj Party,588,1,589,0.41,Gujarat-Rapar -6
5,GOSHWAMI SANJAYGIRI RAMESHGIRI,Independent,278,1,279,0.19,Gujarat-Rapar -6
6,NAVINCHANDRA MANJI JOSARFAL,Independent,225,1,226,0.16,Gujarat-Rapar -6
7,RAMESHBHAI PUNJABHAI PATNI,Independent,350,4,354,0.24,Gujarat-Rapar -6
8,RAJESHBHAI BABUBHAI DUDASNA,Independent,489,6,495,0.34,Gujarat-Rapar -6
9,RATHOD AMBABHAI MAYAJAR,Independent,694,3,697,0.48,Gujarat-Rapar -6
10,VANIYA TEJABHAI GELABHAI,Independent,939,2,941,0.65,Gujarat-Rapar -6
11,SAIYAD HASAMSHA UMARSHA,Independent,1731,1,1732,1.19,Gujarat-Rapar -6
12,NOTA,None of the Above,3938,4,3942,2.72,Gujarat-Rapar -6
1,THAKOR GENIBEN NAGAJI,Indian National Congress,101782,731,102513,45.26,Gujarat-Vav -7
2,THAKOR SWARUPJI SARDARJI,Bharatiya Janata Party,86224,688,86912,38.37,Gujarat-Vav -7
3,PARMAR NAYANABEN RANABHAI,Bahujan Samaj Party,1844,5,1849,0.82,Gujarat-Vav -7
4,BHEMAJIBHAI PATEL,Aam Aadmi Party,1503,93,1596,0.7,Gujarat-Vav -7
5,AMIRAMBHAI SHANKARLAL ASHAL,Independent,27088,258,27346,12.07,Gujarat-Vav -7
6,SHANTIBHAI HAJABHAI RATHOD,Independent,2267,22,2289,1.01,Gujarat-Vav -7
7,NOTA,None of the Above,3994,3,3997,1.76,Gujarat-Vav -7
1,GULABSINH PIRABHAI RAJPUT,Indian National Congress,90977,408,91385,42.07,Gujarat-Tharad -8
2,SHANKARBHAI LAGDHIRBHAI CHAUDHARY,Bharatiya Janata Party,116842,1049,117891,54.27,Gujarat-Tharad -8
3,HADIYAL MAHESHKUMAR RANCHHODBHAI,Bahujan Samaj Party,717,3,720,0.33,Gujarat-Tharad -8
4,PRAKASHBHAI MANJIBHAI DARAJI,Sardar Vallabhbhai Patel Party,136,1,137,0.06,Gujarat-Tharad -8
5,BHARATKUMAR KHEMABHAI CHARAMTA,Praja Vijay Paksh,74,0,74,0.03,Gujarat-Tharad -8
6,RAMESHJI VANAJI MAKVANA,Garvi Gujarat Party,68,0,68,0.03,Gujarat-Tharad -8
7,VIRCHANDBHAI CHELABHAI CHAVDA,Aam Aadmi Party,256,22,278,0.13,Gujarat-Tharad -8
8,KAMLESHBHAI KALUBHAI DESAI,Independent,91,0,91,0.04,Gujarat-Tharad -8
9,THAKOR LAXMIBEN SHURESHBHAI,Independent,164,2,166,0.08,Gujarat-Tharad -8
10,PARMAR SEDHABHAI VAGHABHAI,Independent,206,1,207,0.1,Gujarat-Tharad -8
11,BOCHIYA MOHANBHAI ISHVARBHAI,Independent,211,0,211,0.1,Gujarat-Tharad -8
12,BRAHMKSHATRIYA BHAGAVTIBEN KHETSINHBHAI,Independent,190,0,190,0.09,Gujarat-Tharad -8
13,VARAN MANUBHAI VALABHAI,Independent,476,0,476,0.22,Gujarat-Tharad -8
14,SARTANBHAI VAKHATABHAI HADIYAL,Independent,1878,0,1878,0.86,Gujarat-Tharad -8
15,NOTA,None of the Above,3460,6,3466,1.6,Gujarat-Tharad -8
1,PATEL NATHABHAI HEGOLABHAI,Indian National Congress,37922,338,38260,18.7,Gujarat-Dhanera -9
2,PATEL BHAGVANBHAI HAJABHAI,Bharatiya Janata Party,59943,414,60357,29.51,Gujarat-Dhanera -9
3,PRAKASHBHAI REVABHAI SOLANKI,Bahujan Samaj Party,2137,17,2154,1.05,Gujarat-Dhanera -9
4,DEVDA SURESHKUMAR TRIKAMAJI,Aam Aadmi Party,1083,47,1130,0.55,Gujarat-Dhanera -9
5,LASHABHAI LAVAJIBHAI BAJAG,Janata Dal  (Secular),426,1,427,0.21,Gujarat-Dhanera -9
6,DALPATJI KESARJI CHAUHAN,Independent,966,8,974,0.48,Gujarat-Dhanera -9
7,DINESHBHAI PATAJI CHAUHAN,Independent,1395,0,1395,0.68,Gujarat-Dhanera -9
8,MAVJIBHAI MAGANBHAI DESAI,Independent,95600,453,96053,46.96,Gujarat-Dhanera -9
9,NOTA,None of the Above,3809,2,3811,1.86,Gujarat-Dhanera -9
1,KANTIBHAI KALABHAI KHARADI,Indian National Congress,84691,443,85134,46.42,Gujarat-Danta -10
2,PARGHI LATUBHAI CHANDABHAI,Bharatiya Janata Party,78251,556,78807,42.97,Gujarat-Danta -10
3,BUMBADIYA MAHENDRABHAI KESHARABHAI,Aam Aadmi Party,11861,320,12181,6.64,Gujarat-Danta -10
4,DHRANGI KALABHAI MAVABHAI,Independent,2073,9,2082,1.14,Gujarat-Danta -10
5,NOTA,None of the Above,5201,12,5213,2.84,Gujarat-Danta -10
1,JIGNESH MEVANI,Indian National Congress,93848,917,94765,48,Gujarat-Vadgam -11
2,MANIBHAI JETHABHAI VAGHELA,Bharatiya Janata Party,89052,785,89837,45.51,Gujarat-Vadgam -11
3,SOLANKI RAJANIKANT HIRABHAI,Bahujan Samaj Party,644,4,648,0.33,Gujarat-Vadgam -11
4,JAYSHRIBEN DAHYABHAI PARMAR,Pachchasi Parivartan Samaj Party,218,2,220,0.11,Gujarat-Vadgam -11
5,DABHI SHARMISHTABEN LALJIBHAI,Janata Dal  (Secular),176,2,178,0.09,Gujarat-Vadgam -11
6,DALPATBHAI DAHYABHAI BHATIYA,Aam Aadmi Party,4322,171,4493,2.28,Gujarat-Vadgam -11
7,SUNDHIYA KALPESHKUMAR RAMESHBHAI,All India Majlis-E-Ittehadul Muslimeen,2233,1,2234,1.13,Gujarat-Vadgam -11
8,DATTULBHAI SOMALAL JOSHI,Independent,287,3,290,0.15,Gujarat-Vadgam -11
9,DINESHKUMAR ALJIBHAI  SOLANKI,Independent,224,0,224,0.11,Gujarat-Vadgam -11
10,BHATIYA PIYUSHBHAI BHIKHABHAI,Independent,458,1,459,0.23,Gujarat-Vadgam -11
11,MAHESWARI MANJULABEN VANRAJBHAI,Independent,1194,1,1195,0.61,Gujarat-Vadgam -11
12,NOTA,None of the Above,2857,20,2877,1.46,Gujarat-Vadgam -11
1,ANIKET GIRISHBHAI THAKER,Bharatiya Janata Party,94692,896,95588,52.93,Gujarat-Palanpur -12
2,MAHESHKUMAR AMRUTLAL PATEL,Indian National Congress,67648,960,68608,37.99,Gujarat-Palanpur -12
3,SHAILESHBHAI KARSHANBHAI PARMAR,Bahujan Samaj Party,1259,8,1267,0.7,Gujarat-Palanpur -12
4,RAMESHKUMAR KHEMRAJBHAI NABHANI,Aam Aadmi Party,9138,468,9606,5.32,Gujarat-Palanpur -12
5,CHUNARA GULSHANBEN AHEMADBHAI,Independent,331,2,333,0.18,Gujarat-Palanpur -12
6,JAVIDKHAN JAFARKHAN PARMAR,Independent,307,3,310,0.17,Gujarat-Palanpur -12
7,PARMAR CHHAGANCHANDARAJ DHANABHAI,Independent,344,2,346,0.19,Gujarat-Palanpur -12
8,MANISH BRAHMBHATT (KRANTIKARI),Independent,952,12,964,0.53,Gujarat-Palanpur -12
9,SHRIMALI ASHOKBHAI BALCHANDBHAI,Independent,874,5,879,0.49,Gujarat-Palanpur -12
10,NOTA,None of the Above,2679,23,2702,1.5,Gujarat-Palanpur -12
1,PRAVINKUMAR GORDHANJI MALI,Bharatiya Janata Party,97330,676,98006,45.51,Gujarat-Deesa -13
2,SANJAYKUMAR GOVABHAI RABARI,Indian National Congress,54977,382,55359,25.71,Gujarat-Deesa -13
3,ASHOKBHAI POPATBHAI PARMAR,Garvi Gujarat Party,944,0,944,0.44,Gujarat-Deesa -13
4,JASHVANTKUMAR PADHIYAR,National Maha Sabha Party,322,2,324,0.15,Gujarat-Deesa -13
5,DR.RAMESHBHAI PATEL,Aam Aadmi Party,9003,325,9328,4.33,Gujarat-Deesa -13
6,SONI NITINKUMAR,Praja Vijay Paksh,450,0,450,0.21,Gujarat-Deesa -13
7,JAYANTIBHAI  NAVABHAI CHAUDHARY,Independent,934,0,934,0.43,Gujarat-Deesa -13
8,DINESHBHAI SAGTHABHAI PATEL,Independent,329,3,332,0.15,Gujarat-Deesa -13
9,PATEL JAYANTIBHAI SAGTHABHAI,Independent,534,0,534,0.25,Gujarat-Deesa -13
10,LEBJIBHAI THAKOR,Independent,44890,168,45058,20.92,Gujarat-Deesa -13
11,VAGHELA GAJUBHA MOHANSING,Independent,1235,1,1236,0.57,Gujarat-Deesa -13
12,NOTA,None of the Above,2845,6,2851,1.32,Gujarat-Deesa -13
1,KESHAJI SHIVAJI CHAUHAN,Bharatiya Janata Party,108560,563,109123,56.66,Gujarat-Deodar -14
2,MANSUNGBHAI MASHRUBHAI PARMAR,Bahujan Samaj Party,2463,3,2466,1.28,Gujarat-Deodar -14
3,SHIVABHAI AMARABHAI BHURIYA,Indian National Congress,70007,702,70709,36.71,Gujarat-Deodar -14
4,NAYANSINH NARSINHBHAI PADHAR,Praja Vijay Paksh,2149,20,2169,1.13,Gujarat-Deodar -14
5,BHEMABHAI RAGNATHBHAI CHAUDHARY,Aam Aadmi Party,4863,202,5065,2.63,Gujarat-Deodar -14
6,NOTA,None of the Above,3065,6,3071,1.59,Gujarat-Deodar -14
1,AMRUTJI MOTIJI THAKOR,Indian National Congress,96137,487,96624,47.81,Gujarat-Kankrej -15
2,MAHESHBHAI VERSHIBHAI MAKAVANA,Bahujan Samaj Party,2136,3,2139,1.06,Gujarat-Kankrej -15
3,VAGHELA KIRTISINH PRABHATSINH,Bharatiya Janata Party,90788,541,91329,45.19,Gujarat-Kankrej -15
4,MUKESHKUMAR SOMALAL THAKKAR,Aam Aadmi Party,4965,96,5061,2.5,Gujarat-Kankrej -15
5,RATHOD MAVJI BHEMAJI,Jan Sewa Driver Party,829,2,831,0.41,Gujarat-Kankrej -15
6,CHAUDHARI BABUBHAI MAHDEVBHAI,Independent,1240,2,1242,0.61,Gujarat-Kankrej -15
7,THAKOR GANDAJI MANAJI,Independent,1050,1,1051,0.52,Gujarat-Kankrej -15
8,NOTA,None of the Above,3805,6,3811,1.89,Gujarat-Kankrej -15
1,Raghubhai Merajbhai Desai,Indian National Congress,81405,640,82045,41.37,Gujarat-Radhanpur -16
2,Lavingji Muljiji Solanki,Bharatiya Janata Party,103925,587,104512,52.7,Gujarat-Radhanpur -16
3,Sadhu Devendarkumar Sitaramdas,Gujarat Nav Nirman Sena,1150,2,1152,0.58,Gujarat-Radhanpur -16
4,Dolsangji D Thakor,Jan Sewa Driver Party,348,0,348,0.18,Gujarat-Radhanpur -16
5,Raval Bhurabhai Motibhai,Samajwadi Party,272,0,272,0.14,Gujarat-Radhanpur -16
6,Thakor Lalabhai Raghubhai,Aam Aadmi Party,2560,79,2639,1.33,Gujarat-Radhanpur -16
7,Kishan Kalubhai Thakor,Independent,300,1,301,0.15,Gujarat-Radhanpur -16
8,Thakor Versiji Dhamaji,Independent,783,2,785,0.4,Gujarat-Radhanpur -16
9,Tanna Girdharibhai Chunilal,Independent,453,0,453,0.23,Gujarat-Radhanpur -16
10,Patel Pankajkumar Atmaram,Independent,669,2,671,0.34,Gujarat-Radhanpur -16
11,Sadhu Mayaram Karsandas,Independent,1559,0,1559,0.79,Gujarat-Radhanpur -16
12,NOTA,None of the Above,3561,10,3571,1.8,Gujarat-Radhanpur -16
1,Thakor Dineshbhai Ataji,Indian National Congress,85479,927,86406,46.43,Gujarat-Chanasma -17
2,Dilipkumar Virajibhai Thakor,Bharatiya Janata Party,84383,619,85002,45.67,Gujarat-Chanasma -17
3,Thakor Diwanji Hemaji,Garvi Gujarat Party,1455,3,1458,0.78,Gujarat-Chanasma -17
4,Vishnubhai Jorabhai Patel,Aam Aadmi Party,7324,262,7586,4.08,Gujarat-Chanasma -17
5,Shivanandji Sarswati Gurushree Madhvanandji,Gujarat Nav Nirman Sena,572,4,576,0.31,Gujarat-Chanasma -17
6,Shankarbhai Sagarambhai Rabari,Jan Sewa Driver Party,741,4,745,0.4,Gujarat-Chanasma -17
7,Baloch Jalamkhan Kayamkhan,Independent,1052,0,1052,0.57,Gujarat-Chanasma -17
8,NOTA,None of the Above,3278,15,3293,1.77,Gujarat-Chanasma -17
1,KIRITKUMAR CHIMANLAL PATEL,Indian National Congress,102166,1339,103505,50.16,Gujarat-Patan -18
2,DR. RAJULBEN DESAI,Bharatiya Janata Party,85765,563,86328,41.84,Gujarat-Patan -18
3,SARVAKAR HASUMATIBEN PARASHOTTAMBHAI,Bahujan Samaj Party,904,9,913,0.44,Gujarat-Patan -18
4,THAKOR JAYNTIJI HIRAJI,Garvi Gujarat Party,230,1,231,0.11,Gujarat-Patan -18
5,THAKOR PRAHLADSANG DHUDAJI,Jan Sewa Driver Party,145,1,146,0.07,Gujarat-Patan -18
6,BHARTJI KANTIJI THAKOR,National Maha Sabha Party,279,0,279,0.14,Gujarat-Patan -18
7,LALESHBHAI THAKKAR,Aam Aadmi Party,6598,210,6808,3.3,Gujarat-Patan -18
8,THAKOR SARJIJI KANJIJI,Independent,142,0,142,0.07,Gujarat-Patan -18
9,PATEL JAYESHKUMAR GORDHANBHAI,Independent,201,1,202,0.1,Gujarat-Patan -18
10,PARMAR HITENDRAKUMAR GANESHBHAI,Independent,272,2,274,0.13,Gujarat-Patan -18
11,PRATAPJI PUNJAJI THAKOR,Independent,212,0,212,0.1,Gujarat-Patan -18
12,PRAVINBHAI DAHYALAL JADAV,Independent,310,13,323,0.16,Gujarat-Patan -18
13,PRHLADJI PRADHANJI THAKOR,Independent,487,0,487,0.24,Gujarat-Patan -18
14,MANSURI TOFIKBHAI UMARBHAI,Independent,646,1,647,0.31,Gujarat-Patan -18
15,ROHIT SENMA ALIAS NAGJI,Independent,1040,1,1041,0.5,Gujarat-Patan -18
16,SHABBIRHUSEN AAJAMBHAI MALEK,Independent,2332,1,2333,1.13,Gujarat-Patan -18
17,NOTA,None of the Above,2474,7,2481,1.2,Gujarat-Patan -18
1,Govindbhai Rathod,Bahujan Samaj Party,2037,3,2040,1.08,Gujarat-Sidhpur -19
2,Chandanji Talaji Thakor,Indian National Congress,88112,261,88373,46.7,Gujarat-Sidhpur -19
3,Balvantsinh Chandansinh Rajput,Bharatiya Janata Party,90871,316,91187,48.19,Gujarat-Sidhpur -19
4,Abbasbhai Mohammadsharif Nodsola,All India Majlis-E-Ittehadul Muslimeen,1136,1,1137,0.6,Gujarat-Sidhpur -19
5,Thakor Sanjayji,Pachchasi Parivartan Samaj Party,252,1,253,0.13,Gujarat-Sidhpur -19
6,Rajput Mahendrasinh Dalpatsinh,Aam Aadmi Party,2023,59,2082,1.1,Gujarat-Sidhpur -19
7,Kaji Sohil Hanifbhai,Independent,357,1,358,0.19,Gujarat-Sidhpur -19
8,Patel Dilipkumar,Independent,936,2,938,0.5,Gujarat-Sidhpur -19
9,Baloch Hasankhan Dayamkhan,Independent,990,1,991,0.52,Gujarat-Sidhpur -19
10,NOTA,None of the Above,1850,7,1857,0.98,Gujarat-Sidhpur -19
1,Desai Mukeshkumar Monghjibhai,Indian National Congress,50680,816,51496,33.7,Gujarat-Kheralu -20
2,Sardarbhai Shamalbhai Chaudhary,Bharatiya Janata Party,55101,359,55460,36.3,Gujarat-Kheralu -20
3,Chauhan Mukeshsinh Dhirusinh,Garvi Gujarat Party,956,7,963,0.63,Gujarat-Kheralu -20
4,Thakor Dineshji Hajurji,Aam Aadmi Party,2421,179,2600,1.7,Gujarat-Kheralu -20
5,Valjibhai Savjibhai Parmar,Log Party,348,3,351,0.23,Gujarat-Kheralu -20
6,Alok Hiralal Rai,Independent,2055,6,2061,1.35,Gujarat-Kheralu -20
7,Rameshji Jivanji Thakor,Independent,823,1,824,0.54,Gujarat-Kheralu -20
8,Ramsinhji Shankarji Thakor,Independent,36112,272,36384,23.81,Gujarat-Kheralu -20
9,NOTA,None of the Above,2636,12,2648,1.73,Gujarat-Kheralu -20
1,PATEL ARVIND AMRUTLAL (BHURO),Indian National Congress,36845,248,37093,25.03,Gujarat-Unjha -21
2,PATEL KIRITKUMAR KESHAVLAL (K K PATEL),Bharatiya Janata Party,88066,495,88561,59.75,Gujarat-Unjha -21
3,URVISHKUMAR BABUBHAI PATEL,Aam Aadmi Party,18060,401,18461,12.46,Gujarat-Unjha -21
4,PARMAR HASMUKHBHAI VIRABHAI,Bhartiya Jan Parishad,530,4,534,0.36,Gujarat-Unjha -21
5,RABARI RAMESHBHAI SUKHABHAI,Garvi Gujarat Party,552,4,556,0.38,Gujarat-Unjha -21
6,DR. HITESHKUMAR MAHENDRABHAI PARMAR,Nirbhay Bharteey Party,422,4,426,0.29,Gujarat-Unjha -21
7,ARVINDJI ALKHAJI THAKOR,Independent,770,42,812,0.55,Gujarat-Unjha -21
8,NOTA,None of the Above,1768,7,1775,1.2,Gujarat-Unjha -21
1,Rushikesh Ganeshbhai Patel,Bharatiya Janata Party,87803,553,88356,55.11,Gujarat-Visnagar -22
2,Kiritbhai Ishvarbhai Patel,Indian National Congress,53231,720,53951,33.65,Gujarat-Visnagar -22
3,Jayantilal Mohanlal Patel (Advocate),Aam Aadmi Party,12450,381,12831,8,Gujarat-Visnagar -22
4,Thakor Vishnuji Nenaji (Master),Right to Recall Party,577,3,580,0.36,Gujarat-Visnagar -22
5,Prajapati Jagdish kumar Bhikhabhai,Bhartiya Jan Parishad,417,4,421,0.26,Gujarat-Visnagar -22
6,Thakor Sanjayji Amratji,Rashtriya Hind Ekta Dal,153,1,154,0.1,Gujarat-Visnagar -22
7,Khokhar Abdulrashid Shermohmad,Independent,209,1,210,0.13,Gujarat-Visnagar -22
8,Thakor Shankarji Mafaji,Independent,249,4,253,0.16,Gujarat-Visnagar -22
9,Patel Upendrakumar Shankarlal,Independent,478,0,478,0.3,Gujarat-Visnagar -22
10,Parmar Vijaykumar Kodarbhai,Independent,775,1,776,0.48,Gujarat-Visnagar -22
11,NOTA,None of the Above,2305,20,2325,1.45,Gujarat-Visnagar -22
1,THAKOR AMRUTJI(BHOPAJI) BABUJI,Indian National Congress,58261,325,58586,36.02,Gujarat-Becharaji -23
2,THAKOR SUKHAJI SOMAJI,Bharatiya Janata Party,69474,398,69872,42.96,Gujarat-Becharaji -23
3,DINESHKUMAR REVABHAI RATHOD,Bahujan Samaj Party,724,8,732,0.45,Gujarat-Becharaji -23
4,AMITKUMAR PUSKARRAY PATEL(NETAJI),Rashtrawadi Janlok Dal,506,10,516,0.32,Gujarat-Becharaji -23
5,ZALA NARENDRASINH VAJESINH,Garvi Gujarat Party,875,2,877,0.54,Gujarat-Becharaji -23
6,DR. P. C. PATEL,Bharatiya Rashtravadi Paksha,453,5,458,0.28,Gujarat-Becharaji -23
7,SAGARBHAI HARJIBHAI RABARI,Aam Aadmi Party,10350,413,10763,6.62,Gujarat-Becharaji -23
8,SIDDHARAJSINH VAJUBHA ZALA,Jan Sewa Driver Party,447,2,449,0.28,Gujarat-Becharaji -23
9,THAKOR SHAILESHSINH KIRTISINH,Independent,757,2,759,0.47,Gujarat-Becharaji -23
10,BHAVESHKUMAR NAROTAMBHAI PATEL,Independent,17079,99,17178,10.56,Gujarat-Becharaji -23
11,NOTA,None of the Above,2441,25,2466,1.52,Gujarat-Becharaji -23
1,Karsanbhai Punjabhai Solanki,Bharatiya Janata Party,106699,353,107052,53.45,Gujarat-Kadi -24
2,Pravinbhai Ganapatbhai Parmar,Indian National Congress,78528,330,78858,39.37,Gujarat-Kadi -24
3,Bhupendrakumar Bhikhabhai Ravat,Rashtriya Hind Ekta Dal,1078,0,1078,0.54,Gujarat-Kadi -24
4,Hargovan Karsandas Dabhi,Aam Aadmi Party,7061,192,7253,3.62,Gujarat-Kadi -24
5,Kusumben Sureshkumar Rathod,Independent,333,2,335,0.17,Gujarat-Kadi -24
6,Mangalbhai Kacharabhai Makwana,Independent,1497,2,1499,0.75,Gujarat-Kadi -24
7,Laxmichand Pujabhai Chavada,Independent,861,2,863,0.43,Gujarat-Kadi -24
8,Senama Mahendrabhai Somabhai,Independent,836,0,836,0.42,Gujarat-Kadi -24
9,NOTA,None of the Above,2496,9,2505,1.25,Gujarat-Kadi -24
1,Patel Mukeshkumar D.,Bharatiya Janata Party,98127,689,98816,56.07,Gujarat-Mahesana -25
2,Vasudev Tribhovandas Parmar,Bahujan Samaj Party,816,3,819,0.46,Gujarat-Mahesana -25
3,P.K.  Patel,Indian National Congress,52403,619,53022,30.09,Gujarat-Mahesana -25
4,Patel Dishantbhai Dhanjibhai(Bhagat),Aam Aadmi Party,14609,602,15211,8.63,Gujarat-Mahesana -25
5,Nimesh Atmaram Patel,Gunj Satya Ni Janata Party,817,0,817,0.46,Gujarat-Mahesana -25
6,Thakor Arjanji Mohanji,Independent,467,3,470,0.27,Gujarat-Mahesana -25
7,Thakor Kamleshbhai Nenaji,Independent,222,8,230,0.13,Gujarat-Mahesana -25
8,Thakor Pratapji Kadavaji,Independent,198,2,200,0.11,Gujarat-Mahesana -25
9,Taraben Rameshbhai Makwana,Independent,218,0,218,0.12,Gujarat-Mahesana -25
10,Parmar Devangkumar Prabhudas,Independent,232,3,235,0.13,Gujarat-Mahesana -25
11,Raval Anandkumar Manilal,Independent,2711,11,2722,1.54,Gujarat-Mahesana -25
12,Seta Mahomadjubed Ayubbhai (Jakhami),Independent,448,1,449,0.25,Gujarat-Mahesana -25
13,Snehal Ganpatbhai Vaghela,Independent,560,4,564,0.32,Gujarat-Mahesana -25
14,NOTA,None of the Above,2422,27,2449,1.39,Gujarat-Mahesana -25
1,Dr. C. J. CHAVDA,Indian National Congress,77806,943,78749,49.52,Gujarat-Vijapur -26
2,RAMANBHAI D. PATEL(STARLINE),Bharatiya Janata Party,70954,742,71696,45.08,Gujarat-Vijapur -26
3,URVASHIBEN DIPAKBHAI PATEL,Rashtriya Hind Ekta Dal,552,0,552,0.35,Gujarat-Vijapur -26
4,CHIRAGBHAI PATEL(K.K.GROUP),Aam Aadmi Party,4760,259,5019,3.16,Gujarat-Vijapur -26
5,UJASKUMAR RAMESHBHAI PATEL,Independent,183,0,183,0.12,Gujarat-Vijapur -26
6,CHAUDHARI SHANKARBHAI DEVJIBHAI,Independent,265,2,267,0.17,Gujarat-Vijapur -26
7,PARMAR AJITKUMAR HAMIRJI,Independent,511,0,511,0.32,Gujarat-Vijapur -26
8,NOTA,None of the Above,2048,11,2059,1.29,Gujarat-Vijapur -26
1,Kamleshkumar Jayantibhai Patel,Indian National Congress,88033,1899,89932,44.01,Gujarat-Himatnagar -27
2,Parmar Anilkumar Ramanlal,Bahujan Samaj Party,1173,8,1181,0.58,Gujarat-Himatnagar -27
3,Vinendrasinh Dilipsinh Zala,Bharatiya Janata Party,97879,913,98792,48.35,Gujarat-Himatnagar -27
4,Nirmalsinh Ajabsinh Parmar,Aam Aadmi Party,9513,498,10011,4.9,Gujarat-Himatnagar -27
5,Pathan Usmangani Mahmdkhan,Independent,315,1,316,0.15,Gujarat-Himatnagar -27
6,Sanghani Salmankhan Mustakbhai,Independent,326,1,327,0.16,Gujarat-Himatnagar -27
7,Sanghani Sikandarbhai Mustakbhai,Independent,736,0,736,0.36,Gujarat-Himatnagar -27
8,Solanki Maganbhai Lakhabhai,Independent,578,1,579,0.28,Gujarat-Himatnagar -27
9,NOTA,None of the Above,2436,20,2456,1.2,Gujarat-Himatnagar -27
1,RAMANLAL ISHWARLAL VORA,Bharatiya Janata Party,113137,784,113921,55.16,Gujarat-Idar -28
2,RAMABHAI VIRCHANDBHAI SOLANKI,Indian National Congress,73801,680,74481,36.06,Gujarat-Idar -28
3,JAYANTIBHAI PRANAMI,Aam Aadmi Party,14166,402,14568,7.05,Gujarat-Idar -28
4,NOTA,None of the Above,3556,12,3568,1.73,Gujarat-Idar -28
1,Ashvin Kotval,Bharatiya Janata Party,65256,429,65685,31.86,Gujarat-Khedbrahma -29
2,Dr.Tushar Amarsinh Chaudhary,Indian National Congress,67050,299,67349,32.67,Gujarat-Khedbrahma -29
3,Gameti Bipinchandra Rupasibhai,Aam Aadmi Party,54630,960,55590,26.96,Gujarat-Khedbrahma -29
4,Dabhi Savjibhai Lakhmabhai,Bhartiya Jan Parishad,2183,5,2188,1.06,Gujarat-Khedbrahma -29
5,Pandor Ravajibhai Veljibhai,Bhartiya Tribal Party,1531,8,1539,0.75,Gujarat-Khedbrahma -29
6,Robinsonbhai Simonbhai Chauhan,Loktantrik Rashrtavadi Party,692,1,693,0.34,Gujarat-Khedbrahma -29
7,Parmar Rakeshkumar Babubhai,Independent,1317,4,1321,0.64,Gujarat-Khedbrahma -29
8,Rameshkumar Ramjibhai Modiya,Independent,1883,3,1886,0.91,Gujarat-Khedbrahma -29
9,Shantilal Asari,Independent,2591,1,2592,1.26,Gujarat-Khedbrahma -29
10,NOTA,None of the Above,7320,11,7331,3.56,Gujarat-Khedbrahma -29
1,Parghi Rajendrakumar Kantibhai,Indian National Congress,42351,480,42831,20.67,Gujarat-Bhiloda -30
2,P.C.Baranda,Bharatiya Janata Party,89626,770,90396,43.62,Gujarat-Bhiloda -30
3,Asari Amrutbhai Dharmabhai,Gujarat Nav Nirman Sena,3527,19,3546,1.71,Gujarat-Bhiloda -30
4,Rupsibhai Babubhai Bhagora,Aam Aadmi Party,60148,1480,61628,29.74,Gujarat-Bhiloda -30
5,Dr.Mark Katara,Bhartiya Tribal Party,2586,25,2611,1.26,Gujarat-Bhiloda -30
6,Varunkumar Kalyansinh Katara,Gunj Satya Ni Janata Party,1892,1,1893,0.91,Gujarat-Bhiloda -30
7,Pandor Kaushikkumar Shankarbhai,Independent,1401,1,1402,0.68,Gujarat-Bhiloda -30
8,NOTA,None of the Above,2908,8,2916,1.41,Gujarat-Bhiloda -30
1,THAKOR RAJENDRASINH SHIVSINH,Indian National Congress,62982,705,63687,34.29,Gujarat-Modasa -31
2,DAHYABHAI RAMABHAI JADAV,Communist Party of India  (Marxist),1043,1,1044,0.56,Gujarat-Modasa -31
3,BHIKHUSINHJI CHATURSINHJI PARMAR,Bharatiya Janata Party,97523,952,98475,53.02,Gujarat-Modasa -31
4,PATALA ASHOKBHAI SUKHABHAI,Insaniyat Party,993,0,993,0.53,Gujarat-Modasa -31
5,PATEL PRAVINBHAI KARSANBHAI,Rashtriya Jankranti Party,561,3,564,0.3,Gujarat-Modasa -31
6,"PROFESSOR, RAJENDRASINH HIMMATSINH PARMAR",Aam Aadmi Party,14102,669,14771,7.95,Gujarat-Modasa -31
7,NATVARBHAI MAGANBHAI PARMAR,Independent,256,1,257,0.14,Gujarat-Modasa -31
8,NINAMA HARDIKKUMAR VIRJIBHAI,Independent,176,2,178,0.1,Gujarat-Modasa -31
9,BAKROLIYA MOHAMADADNAN ABDULMAJIDBHAI,Independent,180,0,180,0.1,Gujarat-Modasa -31
10,MAHAMAD HANIFBHAI AHEMADBHAI PATEL,Independent,461,4,465,0.25,Gujarat-Modasa -31
11,RAHULKUMAR KACHARABHAI SOLANKI,Independent,1834,9,1843,0.99,Gujarat-Modasa -31
12,VAGHELA DHANJIBHAI HIRABHAI,Independent,703,0,703,0.38,Gujarat-Modasa -31
13,NOTA,None of the Above,2576,9,2585,1.39,Gujarat-Modasa -31
1,BHIKHIBEN GIRVATSINH PARMAR,Bharatiya Janata Party,60928,332,61260,35.5,Gujarat-Bayad -32
2,MAHENDRASINH SHANKERSINH VAGHELA,Indian National Congress,29579,295,29874,17.31,Gujarat-Bayad -32
3,KANTIBHAI NATHABHAI KHANT,Rashtriya Hind Ekta Dal,1664,0,1664,0.96,Gujarat-Bayad -32
4,KHANT BHUPATBHAI DANLABHAI,Gujarat Nav Nirman Sena,560,1,561,0.33,Gujarat-Bayad -32
5,CHUNIBHAI BABABHAI PATEL,Aam Aadmi Party,5743,204,5947,3.45,Gujarat-Bayad -32
6,THAKOR POKARSINH PRATAPSINH,Log Party,376,1,377,0.22,Gujarat-Bayad -32
7,PAGI LAXMANBHAI REVABHAI,Insaniyat Party,324,2,326,0.19,Gujarat-Bayad -32
8,MANGALSINH RAMANBHAI KHANT,Garvi Gujarat Party,764,1,765,0.44,Gujarat-Bayad -32
9,DHAVALSINH NARENDRASINH ZALA,Independent,66759,319,67078,38.87,Gujarat-Bayad -32
10,RAMSIBHAI LAKHABHAI BHARVAD,Independent,761,1,762,0.44,Gujarat-Bayad -32
11,HASMUKH M SAXENA (JANNAYAK),Independent,1646,16,1662,0.96,Gujarat-Bayad -32
12,NOTA,None of the Above,2302,2,2304,1.34,Gujarat-Bayad -32
1,GAJENDRASINH UDESINH PARMAR,Bharatiya Janata Party,104484,840,105324,57.23,Gujarat-Prantij -33
2,BAHECHARSINH HARISINH RATHOD,Indian National Congress,40363,339,40702,22.12,Gujarat-Prantij -33
3,ALPESHKUMAR NARESHBHAI PATEL,Aam Aadmi Party,31231,908,32139,17.46,Gujarat-Prantij -33
4,JYOTIBEN ASHOKBHAI RATHOD,Right to Recall Party,619,2,621,0.34,Gujarat-Prantij -33
5,CHAUHAN VIJAYSINH KARANSINH,Independent,1016,2,1018,0.55,Gujarat-Prantij -33
6,NADIYA CHANDUBHAI MOTIBHAI,Independent,1110,0,1110,0.6,Gujarat-Prantij -33
7,NOTA,None of the Above,3105,9,3114,1.69,Gujarat-Prantij -33
1,CHAUHAN BALRAJSINH KALYANSINH,Bharatiya Janata Party,74721,412,75133,49.26,Gujarat-Dahegam -34
2,CHAUHAN VAKHATSINH AMARASINH,Indian National Congress,58687,273,58960,38.65,Gujarat-Dahegam -34
3,ASHOKBHAI NATUBHAI RATHOD,Right to Recall Party,890,1,891,0.58,Gujarat-Dahegam -34
4,JAYENDRA K. RATHOD,Vyavastha Parivartan Party,386,4,390,0.26,Gujarat-Dahegam -34
5,RUPALBA MOHABATSINH CHAUHAN,Garvi Gujarat Party,982,3,985,0.65,Gujarat-Dahegam -34
6,SUHAG PANCHAL,Aam Aadmi Party,12180,214,12394,8.13,Gujarat-Dahegam -34
7,AMRUTBHAI PURSHOTTAMBHAI PATEL,Independent,1092,0,1092,0.72,Gujarat-Dahegam -34
8,NOTA,None of the Above,2681,8,2689,1.76,Gujarat-Dahegam -34
1,ALPESH KHODAJI THAKOR,Bharatiya Janata Party,133339,712,134051,54.59,Gujarat-Gandhinagar South -35
2,RAJESHKUMAR MANGABHAI PARMAR,Bahujan Samaj Party,1678,15,1693,0.69,Gujarat-Gandhinagar South -35
3,Dr. HIMANSHU PATEL (ADALAJ),Indian National Congress,90017,970,90987,37.05,Gujarat-Gandhinagar South -35
4,CHAUDHARI KISHORSINH SHRICHAND,Jan Sewa Driver Party,583,0,583,0.24,Gujarat-Gandhinagar South -35
5,DEVENDRABHAI(DOLATBHAI) PRAVINCHANDRA PATEL,Aam Aadmi Party,10733,462,11195,4.56,Gujarat-Gandhinagar South -35
6,RAJENDRA SURESHBHAI PARMAR,Bhartiya Jan Parishad,298,2,300,0.12,Gujarat-Gandhinagar South -35
7,ACHARYA KEYUR CHIMANBHAI,Independent,304,3,307,0.13,Gujarat-Gandhinagar South -35
8,KISHORPURI CHANDANPURI GAUSWAMI,Independent,204,3,207,0.08,Gujarat-Gandhinagar South -35
9,RAJVEER,Independent,435,1,436,0.18,Gujarat-Gandhinagar South -35
10,SOLANKI DHARMENDRAKUMAR CHIMANBHAI,Independent,577,1,578,0.24,Gujarat-Gandhinagar South -35
11,SOLANKI VINODKUMAR KACHARABHAI,Independent,799,4,803,0.33,Gujarat-Gandhinagar South -35
12,NOTA,None of the Above,4416,26,4442,1.81,Gujarat-Gandhinagar South -35
1,RITABEN KETANKUMAR PATEL,Bharatiya Janata Party,79635,988,80623,51.25,Gujarat-Gandhinagar North -36
2,VIRENDRASINH MAFAJI VAGHELA (AJITSINH-VASAN),Indian National Congress,53355,1157,54512,34.65,Gujarat-Gandhinagar North -36
3,THAKOR DHARMESH (DHAMBHA THAKOR),Garvi Gujarat Party,1024,27,1051,0.67,Gujarat-Gandhinagar North -36
4,PATEL MUKESHBHAI KARSHANBHAI,Aam Aadmi Party,15697,923,16620,10.56,Gujarat-Gandhinagar North -36
5,ALKESHBHAI BALDEVBHAI PARMAR,Independent,514,5,519,0.33,Gujarat-Gandhinagar North -36
6,PATNI MAHENDRABHAI SOMABHAI,Independent,275,4,279,0.18,Gujarat-Gandhinagar North -36
7,PATHAN MOHAMMAD IZHARKHAN ALDADKHAN,Independent,127,3,130,0.08,Gujarat-Gandhinagar North -36
8,MAHAMDFARUKH BISMILLAKHAN PATHAN,Independent,155,3,158,0.1,Gujarat-Gandhinagar North -36
9,RAJ PRAJAPATI,Independent,318,2,320,0.2,Gujarat-Gandhinagar North -36
10,SHRIMALI MRUGESHKUMAR AMRUTBHAI,Independent,500,2,502,0.32,Gujarat-Gandhinagar North -36
11,NOTA,None of the Above,2561,52,2613,1.66,Gujarat-Gandhinagar North -36
1,JAYANTIBHAI SOMABHAI PATEL (J.S. PATEL),Bharatiya Janata Party,97708,436,98144,59.29,Gujarat-Mansa -37
2,NARESHBHAI MULJIBHAI PARMAR,Bahujan Samaj Party,987,3,990,0.6,Gujarat-Mansa -37
3,BABUSINHJI MOHANSINHJI THAKOR,Indian National Congress,58460,418,58878,35.57,Gujarat-Mansa -37
4,CHAVDA RAJENDRAKUMAR GANDAJI,Rashtriya Hind Ekta Dal,510,0,510,0.31,Gujarat-Mansa -37
5,BHASKARBHAI BABUBHAI PATEL,Aam Aadmi Party,2778,187,2965,1.79,Gujarat-Mansa -37
6,RAHUL RAMAANIWAS MISHRA,National Youth Party,125,0,125,0.08,Gujarat-Mansa -37
7,ARVINDJI JIVANJI THAKOR,Independent,164,4,168,0.1,Gujarat-Mansa -37
8,THAKOR ASWINBHAI TALAJI,Independent,331,0,331,0.2,Gujarat-Mansa -37
9,BHARATKUMAR AMARAJI THAKOR,Independent,669,0,669,0.4,Gujarat-Mansa -37
10,MAHIPALSINH RAJENDRASINH VAGHELA,Independent,523,2,525,0.32,Gujarat-Mansa -37
11,NOTA,None of the Above,2225,7,2232,1.35,Gujarat-Mansa -37
1,THAKOR  LAXMANJI PUNJAJI (BAKAJI),Bharatiya Janata Party,85981,121,86102,49.41,Gujarat-Kalol -38
2,BALDEVJI CHANDUJI THAKOR,Indian National Congress,80275,94,80369,46.12,Gujarat-Kalol -38
3,MAHENDRABHAI VALJIBHAI  SOLANKI,Bahujan Samaj Party,938,2,940,0.54,Gujarat-Kalol -38
4,KANTIJI ATMARAM THAKOR (JAGIRDAR),Aam Aadmi Party,2051,18,2069,1.19,Gujarat-Kalol -38
5,THAKOR BHUPATSINH KHODAJI,Garvi Gujarat Party,177,0,177,0.1,Gujarat-Kalol -38
6,HITENDRABHAI  PAREJIYA (PATEL),Aadi Bharat Party,108,0,108,0.06,Gujarat-Kalol -38
7,UPASAK MAHENDRASHEEL SOMABHAI (B.R.P.),Independent,233,0,233,0.13,Gujarat-Kalol -38
8,THAKOR POPATJI AMAJI,Independent,173,0,173,0.1,Gujarat-Kalol -38
9,THAKOR RAMSANGJI KANTIJI,Independent,170,0,170,0.1,Gujarat-Kalol -38
10,PATEL RAJNIKANT AMBALAL  (BACHUKAKA),Independent,286,0,286,0.16,Gujarat-Kalol -38
11,PRAJAPATI KANAIYALAL KESHAVLAL  (KANUBHAI),Independent,321,1,322,0.18,Gujarat-Kalol -38
12,VAGHELA  RAMESHBHAI  DEVJIBHAI,Independent,905,0,905,0.52,Gujarat-Kalol -38
13,NOTA,None of the Above,2391,3,2394,1.37,Gujarat-Kalol -38
1,PATEL HARDIK BHARATBHAI,Bharatiya Janata Party,98627,528,99155,49.64,Gujarat-Viramgam -39
2,BHARWAD LAKHABHAI BHIKHABHAI,Indian National Congress,42412,312,42724,21.39,Gujarat-Viramgam -39
3,AMARSINH ANADAJI THAKOR,Aam Aadmi Party,47072,376,47448,23.75,Gujarat-Viramgam -39
4,ASHOK MAHENDRAPRASAD NIMBARK (MAHARAJ),Gujarat Nav Nirman Sena,732,2,734,0.37,Gujarat-Viramgam -39
5,CHETANJI MERUJI THAKOR,Garvi Gujarat Party,963,1,964,0.48,Gujarat-Viramgam -39
6,TRENTIYA RAKESHKUMAR ARVINDBHAI,Pachchasi Parivartan Samaj Party,210,0,210,0.11,Gujarat-Viramgam -39
7,NARESHBHAI RAJABHAI BHAMANI,Vyavastha Parivartan Party,371,0,371,0.19,Gujarat-Viramgam -39
8,KIRIT RATHOD,Independent,957,20,977,0.49,Gujarat-Viramgam -39
9,DEVIPUJAK RAJESHBHAI LAGHRABHAI,Independent,407,0,407,0.2,Gujarat-Viramgam -39
10,MAHENDRA K CHAUHAN (MAMA),Independent,387,8,395,0.2,Gujarat-Viramgam -39
11,MIRZA ABID ALIBHAI,Independent,451,5,456,0.23,Gujarat-Viramgam -39
12,VIRAMBHAI TALPADAKOLI,Independent,479,0,479,0.24,Gujarat-Viramgam -39
13,KO.PA.SUKHABHAI KARMANBHAI,Independent,963,0,963,0.48,Gujarat-Viramgam -39
14,HARDIKKUMAR JAGDISHCHANDRA PATEL,Independent,1217,1,1218,0.61,Gujarat-Viramgam -39
15,NOTA,None of the Above,3240,13,3253,1.63,Gujarat-Viramgam -39
1,KANUBHAI KARAMSHIBHAI PATEL,Bharatiya Janata Party,99689,394,100083,51.4,Gujarat-Sanand -40
2,CHAUHAN KALUBHAI MAPABHAI,Bahujan Samaj Party,1883,5,1888,0.97,Gujarat-Sanand -40
3,PATEL RAMESHBHAI BALABHAI,Indian National Congress,64521,193,64714,33.23,Gujarat-Sanand -40
4,ANSOYABEN PATEL,Aadi Bharat Party,688,1,689,0.35,Gujarat-Sanand -40
5,KULDIPSINH DILIPSINH VAGHELA,Aam Aadmi Party,15599,272,15871,8.15,Gujarat-Sanand -40
6,PAGI GANAPATBHAI MAVJIBHAI,Praja Vijay Paksh,405,1,406,0.21,Gujarat-Sanand -40
7,PRAJAPATI VIJAYKUMAR AMRUTBHAI,Garvi Gujarat Party,406,2,408,0.21,Gujarat-Sanand -40
8,MAHANT DEVENDRA MOHANDAS,Gunj Satya Ni Janata Party,745,1,746,0.38,Gujarat-Sanand -40
9,CHUNARA PRAKASHBHAI BHAILALBHAI,Independent,563,1,564,0.29,Gujarat-Sanand -40
10,PATEL NAVGHANBHAI MANGABHAI,Independent,292,0,292,0.15,Gujarat-Sanand -40
11,MILIND BAUDDH (MANUBHAI),Independent,3583,13,3596,1.85,Gujarat-Sanand -40
12,VAGHARI KANUBHAI GOVINDBHAI,Independent,465,1,466,0.24,Gujarat-Sanand -40
13,VAGHELA ALPESHSINH SURUBHA,Independent,389,0,389,0.2,Gujarat-Sanand -40
14,VAGHELA BHAILALBHAI CHHELABHAI,Independent,1303,0,1303,0.67,Gujarat-Sanand -40
15,SOLANKI MAHESHBHAI RAMANBHAI,Independent,789,0,789,0.41,Gujarat-Sanand -40
16,NOTA,None of the Above,2523,5,2528,1.3,Gujarat-Sanand -40
1,Dr.AMEE YAJNIK,Indian National Congress,21120,147,21267,8.26,Gujarat-Ghatlodia -41
2,PATEL BHUPENDRABHAI RAJNIKANT,Bharatiya Janata Party,212480,1050,213530,82.95,Gujarat-Ghatlodia -41
3,JAYENDRA K. RATHOD,Vyavastha Parivartan Party,524,1,525,0.2,Gujarat-Ghatlodia -41
4,NIMESH ATMARAM PATEL,Gunj Satya Ni Janata Party,776,3,779,0.3,Gujarat-Ghatlodia -41
5,RAHUL CHIMANBHAI MEHTA,Right to Recall Party,181,0,181,0.07,Gujarat-Ghatlodia -41
6,VIJAY PATEL,Aam Aadmi Party,15902,292,16194,6.29,Gujarat-Ghatlodia -41
7,SANJUBEN SOHANLAL REGAR,Jan Sewa Driver Party,284,7,291,0.11,Gujarat-Ghatlodia -41
8,HITENDRA PATEL,Aadi Bharat Party,275,1,276,0.11,Gujarat-Ghatlodia -41
9,NARESH NARAYANBHAI PRIYDARSHI,Independent,374,1,375,0.15,Gujarat-Ghatlodia -41
10,NOTA,None of the Above,3967,26,3993,1.55,Gujarat-Ghatlodia -41
1,AMIT THAKER,Bharatiya Janata Party,127674,375,128049,56.18,Gujarat-Vejalpur -42
2,RAJENDRA PATEL (RAJUBHAI MAKARABA),Indian National Congress,68103,295,68398,30.01,Gujarat-Vejalpur -42
3,KALPESH  PATEL (BHOLABHAI),Aam Aadmi Party,21917,277,22194,9.74,Gujarat-Vejalpur -42
4,ZAINAB SHAIKH,All India Majlis-E-Ittehadul Muslimeen,2310,3,2313,1.01,Gujarat-Vejalpur -42
5,PARTHIV VIJAYKUMAR DAVE,Right to Recall Party,132,0,132,0.06,Gujarat-Vejalpur -42
6,MEMAN MUHAMMADHUSEN ABDULLAHBHAI,SOCIAL DEMOCRATIC PARTY OF INDIA,140,0,140,0.06,Gujarat-Vejalpur -42
7,SHAH ANKIT,Bharatiya Yuva Jan Ekta Party,205,0,205,0.09,Gujarat-Vejalpur -42
8,SHAIKH SHAUKATALI ABDULKARIM,Jan Sewa Driver Party,76,0,76,0.03,Gujarat-Vejalpur -42
9,TANVEERUDDIN ILMUDDIN SHAIKH,Independent,96,1,97,0.04,Gujarat-Vejalpur -42
10,MANSURI SUHANA AHEMADBHAI,Independent,185,1,186,0.08,Gujarat-Vejalpur -42
11,MOHAMAD FARUK SHAIKH,Independent,275,0,275,0.12,Gujarat-Vejalpur -42
12,SHAIKH ARIF (FAUJI),Independent,129,0,129,0.06,Gujarat-Vejalpur -42
13,SABIRALIKHAN SAHEBDALIKHAN PATHAN,Independent,171,0,171,0.08,Gujarat-Vejalpur -42
14,SAIYED PIRHUSEN (YASIN BAPU),Independent,2306,9,2315,1.02,Gujarat-Vejalpur -42
15,SOLANKI VINODBHAI (SAVAJ),Independent,372,1,373,0.16,Gujarat-Vejalpur -42
16,NOTA,None of the Above,2871,19,2890,1.27,Gujarat-Vejalpur -42
1,Balvantsinh Hemantsang Gadhavi,Indian National Congress,51493,171,51664,21.83,Gujarat-Vatva -43
2,Babusinh Sarabhai Jadav,Bharatiya Janata Party,151231,479,151710,64.09,Gujarat-Vatva -43
3,Kalpeshbhai Narayanbhai Shete,Gunj Satya Ni Janata Party,1609,3,1612,0.68,Gujarat-Vatva -43
4,Kartik  Pandey,Praja Vijay Paksh,535,2,537,0.23,Gujarat-Vatva -43
5,Chaudhari Jagbirsingh,Jan Sewa Driver Party,195,2,197,0.08,Gujarat-Vatva -43
6,Jignaba Omkarsinh Zala,Pachchasi Parivartan Samaj Party,377,5,382,0.16,Gujarat-Vatva -43
7,Patel Nikhil Bhikhabhai,Bharatiya National Janta Dal,474,4,478,0.2,Gujarat-Vatva -43
8,Bipin Patel,Aam Aadmi Party,24595,352,24947,10.54,Gujarat-Vatva -43
9,Mahendra Kunjadvala,Jan Man Party,208,0,208,0.09,Gujarat-Vatva -43
10,Mundra Anilkumar Niranjankumar,Log Party,169,0,169,0.07,Gujarat-Vatva -43
11,Rakesh Ramdev Yadav,Samajwadi Party,557,1,558,0.24,Gujarat-Vatva -43
12,Vishal Motilal Saroj,Jan Sangharsh Virat Party,321,1,322,0.14,Gujarat-Vatva -43
13,Sharma Deepakkumar Vasudev,National Maha Sabha Party,384,0,384,0.16,Gujarat-Vatva -43
14,Sujith Diwakar Pandey,Independent,801,4,805,0.34,Gujarat-Vatva -43
15,NOTA,None of the Above,2721,21,2742,1.16,Gujarat-Vatva -43
1,Amit Shah,Bharatiya Janata Party,118803,520,119323,80.39,Gujarat-Ellisbridge -44
2,Bhikhubhai Hargovindbhai Dave (Bhikhu Dave -108),Indian National Congress,14440,87,14527,9.79,Gujarat-Ellisbridge -44
3,Moradiya Pravinbhai Mavjibhai,Bahujan Samaj Party,1074,3,1077,0.73,Gujarat-Ellisbridge -44
4,Meenakshi Joshi,SOCIALIST UNITY CENTRE OF INDIA (COMMUNIST),306,2,308,0.21,Gujarat-Ellisbridge -44
5,Paras Rupeshkumar Shah,Aam Aadmi Party,9333,134,9467,6.38,Gujarat-Ellisbridge -44
6,Mehta Ushabh Kaushikkumar (Rushabh),Bharatiya National Janta Dal,145,0,145,0.1,Gujarat-Ellisbridge -44
7,Surendrabhai Keshavlal Shah,Right to Recall Party,123,0,123,0.08,Gujarat-Ellisbridge -44
8,Amiraj,Independent,187,1,188,0.13,Gujarat-Ellisbridge -44
9,Gajjar Miteshkumar Narendrabhai,Independent,217,2,219,0.15,Gujarat-Ellisbridge -44
10,NOTA,None of the Above,3041,15,3056,2.06,Gujarat-Ellisbridge -44
1,JITENDRAKUMAR RAMANLAL PATEL (JITU BHAGAT),Bharatiya Janata Party,107874,286,108160,77.48,Gujarat-Naranpura -45
2,SENMA SHAILESHKUMAR BHIKHALAL (GIRISH RAVAT),Bahujan Samaj Party,1029,3,1032,0.74,Gujarat-Naranpura -45
3,SONAL RAMANBHAI PATEL,Indian National Congress,15290,70,15360,11,Gujarat-Naranpura -45
4,PUJABHAI VIRABHAI SALAT,Bhartiya Jan Parishad,613,2,615,0.44,Gujarat-Naranpura -45
5,PANKAJBHAI JAYANTILAL PATEL (BHEMABHAI),Aam Aadmi Party,11661,124,11785,8.44,Gujarat-Naranpura -45
6,NOTA,None of the Above,2619,18,2637,1.89,Gujarat-Naranpura -45
1,JAGDISH VISHWAKARMA,Bharatiya Janata Party,93400,314,93714,61.73,Gujarat-Nikol -46
2,RANJITSINH BARAD,Indian National Congress,38354,162,38516,25.37,Gujarat-Nikol -46
3,ASHOKBHAI GAJERA,Aam Aadmi Party,14540,271,14811,9.76,Gujarat-Nikol -46
4,KALPESH N. SHETE (ADVOCATE),Gunj Satya Ni Janata Party,716,0,716,0.47,Gujarat-Nikol -46
5,KALPESHBHAI KHAMAR,Rashtra Mangal Mission Party,192,1,193,0.13,Gujarat-Nikol -46
6,KAZI MOHMMED SALIM,Samajwadi Party,445,0,445,0.29,Gujarat-Nikol -46
7,DHARMENDRA KUMAR PANDEY,Jan Sangharsh Virat Party,124,0,124,0.08,Gujarat-Nikol -46
8,SAMIR RAJESHKUMAR UPADHYAY,Saurashtra Janta Paksha,140,0,140,0.09,Gujarat-Nikol -46
9,AMJADHUSSAIN SHAIKH,Independent,235,0,235,0.15,Gujarat-Nikol -46
10,GEETABEN PATEL,Independent,198,1,199,0.13,Gujarat-Nikol -46
11,MAHERIYA ALPESHBHAI (LALABHAI),Independent,390,3,393,0.26,Gujarat-Nikol -46
12,HAFIZ ANSARI,Independent,392,0,392,0.26,Gujarat-Nikol -46
13,NOTA,None of the Above,1927,12,1939,1.28,Gujarat-Nikol -46
1,KUKRANI PAYAL MANOJKUMAR,Bharatiya Janata Party,112194,573,112767,71.49,Gujarat-Naroda -47
2,MEGHRAJ DODWANI,Nationalist Congress Party,7967,60,8027,5.09,Gujarat-Naroda -47
3,OMPRAKASH DAROGAPRASAD TIWARI,Aam Aadmi Party,28603,651,29254,18.54,Gujarat-Naroda -47
4,GAUTAMBHAI B TRIVEDI,Bhartiya Nagrik Suraksha Party,538,3,541,0.34,Gujarat-Naroda -47
5,TATAD ARCHANABEN GAUTAMBHAI,Jan Sewa Driver Party,193,1,194,0.12,Gujarat-Naroda -47
6,PATEL MITTAL KANUBHAI,Bhartiya Jan Parishad,256,5,261,0.17,Gujarat-Naroda -47
7,PATEL SATYAMKUMAR K,Sardar Vallabhbhai Patel Party,186,2,188,0.12,Gujarat-Naroda -47
8,PANDEY JYOTIBEN MANOJBHAI,Swatantrata Abhivyakti Party,265,0,265,0.17,Gujarat-Naroda -47
9,PRAKASHSINGH SUNDERSINGH RAJPUT,Jan Man Party,271,1,272,0.17,Gujarat-Naroda -47
10,PRAJAPATI NITABEN MUKESHKUMAR,Garvi Gujarat Party,520,6,526,0.33,Gujarat-Naroda -47
11,VISHRAM DHRUVSINH SIKARVAR,Pachchasi Parivartan Samaj Party,204,1,205,0.13,Gujarat-Naroda -47
12,SELUKAR RAKESH SURESHBHAI,Jan Sangharsh Virat Party,202,1,203,0.13,Gujarat-Naroda -47
13,GULWANI RAMKUMAR BALIRAMJI,Independent,254,2,256,0.16,Gujarat-Naroda -47
14,GOHIL MAHENDRASINH LAXMANSINH,Independent,694,12,706,0.45,Gujarat-Naroda -47
15,DIPABEN NILESHBHAI SANTWANI,Independent,376,2,378,0.24,Gujarat-Naroda -47
16,SHARMA BRIJESHKUMAR UJAGARLAL,Independent,1316,0,1316,0.83,Gujarat-Naroda -47
17,SUTHAR AMIT,Independent,901,4,905,0.57,Gujarat-Naroda -47
18,NOTA,None of the Above,1461,24,1485,0.94,Gujarat-Naroda -47
1,Kanchanben Vinubhai Radadiya,Bharatiya Janata Party,89050,359,89409,65.66,Gujarat-Thakkarbapa Nagar -48
2,Vijaykumar C. Brahmabhatt (Vijay Barot),Indian National Congress,25403,207,25610,18.81,Gujarat-Thakkarbapa Nagar -48
3,Radhna Vinaysinh,Sardar Vallabhbhai Patel Party,273,4,277,0.2,Gujarat-Thakkarbapa Nagar -48
4,Sanjay Mori,Aam Aadmi Party,17010,446,17456,12.82,Gujarat-Thakkarbapa Nagar -48
5,Hitendrakumar Madhabhai Patel,Swatantrata Abhivyakti Party,289,1,290,0.21,Gujarat-Thakkarbapa Nagar -48
6,Kshatriya Ranjitsinh Ramanandsinh,Garvi Gujarat Party,258,3,261,0.19,Gujarat-Thakkarbapa Nagar -48
7,Desai Parth Raghunath,Independent,246,1,247,0.18,Gujarat-Thakkarbapa Nagar -48
8,Parmar Arvindkumar Babubhai,Independent,238,6,244,0.18,Gujarat-Thakkarbapa Nagar -48
9,Shaikh Usmanbhai Ibrahimbhai,Independent,460,0,460,0.34,Gujarat-Thakkarbapa Nagar -48
10,NOTA,None of the Above,1891,19,1910,1.4,Gujarat-Thakkarbapa Nagar -48
1,Dineshsinh Rajendrasinh Kushwaha,Bharatiya Janata Party,59133,332,59465,48.85,Gujarat-Bapunagar -49
2,Naginkumar Chimanlal Solanki,Bahujan Samaj Party,521,3,524,0.43,Gujarat-Bapunagar -49
3,Himmatsinh Patel,Indian National Congress,47066,329,47395,38.94,Gujarat-Bapunagar -49
4,Altafkhan Jabbarkhan Pathan,Samajwadi Party,3669,2,3671,3.02,Gujarat-Bapunagar -49
5,Istiyakahmed Siddiqui,Jan Sewa Driver Party,67,0,67,0.06,Gujarat-Bapunagar -49
6,Kiritbhai Govindbhai Chauhan,Right to Recall Party,66,0,66,0.05,Gujarat-Bapunagar -49
7,Chavada Jyotsanaben Somabhai,Sardar Vallabhbhai Patel Party,57,1,58,0.05,Gujarat-Bapunagar -49
8,Tiwari Akash Rammilan,Jan Sangharsh Virat Party,58,1,59,0.05,Gujarat-Bapunagar -49
9,Pathan Emtiazkhan Sidkhan,Janata Dal  (United),29,1,30,0.02,Gujarat-Bapunagar -49
10,Mohammadhusain Liyakatahusain Ansari,Loktantrik Rashrtavadi Party,119,2,121,0.1,Gujarat-Bapunagar -49
11,Rajeshbhai Dixit,Aam Aadmi Party,6135,249,6384,5.24,Gujarat-Bapunagar -49
12,Vijay Naranbhai Sengal,Bahujan Suraksha Dal,81,1,82,0.07,Gujarat-Bapunagar -49
13,Shaikh Mohammedjaved Ilyas,Loktantrik Samajwadi Party,74,0,74,0.06,Gujarat-Bapunagar -49
14,Ansari Almasjaha Nisharahmed,Independent,145,0,145,0.12,Gujarat-Bapunagar -49
15,Gafurkhan Pathan,Independent,105,0,105,0.09,Gujarat-Bapunagar -49
16,Jayesh Ganpatbhai Makwana,Independent,615,0,615,0.51,Gujarat-Bapunagar -49
17,Nandoliya Harshad Babubhai,Independent,637,0,637,0.52,Gujarat-Bapunagar -49
18,Parmar Vipulbhai Mansukhbhai,Independent,109,0,109,0.09,Gujarat-Bapunagar -49
19,Parmar Saurabh Bharatbhai,Independent,245,0,245,0.2,Gujarat-Bapunagar -49
20,Prahladbhai Shakrabhai Parmar,Independent,140,0,140,0.12,Gujarat-Bapunagar -49
21,Mahendrabhai Chavda,Independent,56,0,56,0.05,Gujarat-Bapunagar -49
22,Manjulaben Ranchhodbhai Parmar,Independent,129,0,129,0.11,Gujarat-Bapunagar -49
23,Rasulbhai Dolubhai Rathod,Independent,48,1,49,0.04,Gujarat-Bapunagar -49
24,Rakesh Kanubhai Mahida,Independent,46,1,47,0.04,Gujarat-Bapunagar -49
25,Laxmiben Kanubhai Vaghela,Independent,101,1,102,0.08,Gujarat-Bapunagar -49
26,Vinodbhai Muljibhai Parmar,Independent,170,3,173,0.14,Gujarat-Bapunagar -49
27,Vishal Dineshbhai Makwana,Independent,126,0,126,0.1,Gujarat-Bapunagar -49
28,Shakilabanu Moyusuf Ansari,Independent,102,0,102,0.08,Gujarat-Bapunagar -49
29,Salmankhan Samikhan Pathan,Independent,77,0,77,0.06,Gujarat-Bapunagar -49
30,NOTA,None of the Above,856,15,871,0.72,Gujarat-Bapunagar -49
1,DHARMENDRABHAI SHANTILAL PATEL (DHAMBHAI),Indian National Congress,50392,330,50722,31.83,Gujarat-Amraiwadi -50
2,PARMAR RAMESHBHAI KISHORBHAI,Communist Party of India,687,0,687,0.43,Gujarat-Amraiwadi -50
3,RATHOD YALPESHKUMAR PRAVINBHAI,Bahujan Samaj Party,1519,10,1529,0.96,Gujarat-Amraiwadi -50
4,DR. HASMUKH PATEL,Bharatiya Janata Party,93670,324,93994,58.98,Gujarat-Amraiwadi -50
5,GAUTAMBHAI SADABHAI PARMAR,Garvi Gujarat Party,469,1,470,0.29,Gujarat-Amraiwadi -50
6,NEERAJ SHIVSAGAR SHUKLA,Jan Sangharsh Virat Party,102,1,103,0.06,Gujarat-Amraiwadi -50
7,PATEL MAHESHKUMAR SOMABHAI,Pachchasi Parivartan Samaj Party,71,0,71,0.04,Gujarat-Amraiwadi -50
8,PARMAR BAKULABEN UKABHAI,Rashtra Nirman Party,126,1,127,0.08,Gujarat-Amraiwadi -50
9,BAGHEL RAJESH VISHVANATHSINGH,Vikas India Party,200,0,200,0.13,Gujarat-Amraiwadi -50
10,BHATT SUNILKUMAR NARENDRABHAI,Right to Recall Party,68,0,68,0.04,Gujarat-Amraiwadi -50
11,BHARAT JAIN,Jan Sewa Driver Party,130,0,130,0.08,Gujarat-Amraiwadi -50
12,BHARWAD ANILKUMAR JITUBHAI (ANIL AMDAVADI),Bahujan Republican  Socialist Party,457,4,461,0.29,Gujarat-Amraiwadi -50
13,VINAY NANDLAL GUPTA,Aam Aadmi Party,7552,235,7787,4.89,Gujarat-Amraiwadi -50
14,SATISH HIRALAL SONI,Apni Janta Party,162,1,163,0.1,Gujarat-Amraiwadi -50
15,GYANENDRA DAYANAND VISHWAKARMA,Samajwadi Party,327,1,328,0.21,Gujarat-Amraiwadi -50
16,SOLANKI VINODBHAI BODHABHAI,Independent,629,1,630,0.4,Gujarat-Amraiwadi -50
17,SANJAYBHAI DAHYABHAI PATEL,Independent,666,1,667,0.42,Gujarat-Amraiwadi -50
18,NOTA,None of the Above,1203,21,1224,0.77,Gujarat-Amraiwadi -50
1,Kaushikbhai Sukhlal Jain (Kaushik Jain),Bharatiya Janata Party,61090,400,61490,49.05,Gujarat-Dariapur -51
2,Gyasuddin Habibuddeen Shaikh,Indian National Congress,55847,158,56005,44.67,Gujarat-Dariapur -51
3,Tajmohammed Habibbhai Kureshi,Aam Aadmi Party,4164,195,4359,3.48,Gujarat-Dariapur -51
4,Mo. Tahir Alimiya,Dhanwan Bharat Party,140,2,142,0.11,Gujarat-Dariapur -51
5,Hasankhan Samsherkhan Pathan (Hasanlala),All India Majlis-E-Ittehadul Muslimeen,1771,1,1772,1.41,Gujarat-Dariapur -51
6,Gulamrashul Gulamnabi Bagban (Bataka wala),Independent,96,0,96,0.08,Gujarat-Dariapur -51
7,Solanki Dipeshbhai Parmanandbhai,Independent,204,8,212,0.17,Gujarat-Dariapur -51
8,NOTA,None of the Above,1276,14,1290,1.03,Gujarat-Dariapur -51
1,IMRAN KHEDAWALA,Indian National Congress,58235,252,58487,45.88,Gujarat-Jamalpur - Khadia -52
2,BHUSHAN ASHOK BHATT,Bharatiya Janata Party,44649,180,44829,35.17,Gujarat-Jamalpur - Khadia -52
3,BUKELIYA HITESHBHAI SANJAYBHAI,Rashtriya Power Party,430,2,432,0.34,Gujarat-Jamalpur - Khadia -52
4,SABIRBHAI KABLIWALA,All India Majlis-E-Ittehadul Muslimeen,15655,22,15677,12.3,Gujarat-Jamalpur - Khadia -52
5,SANJUBEN SOHANLAL REGAR,Jan Sewa Driver Party,192,1,193,0.15,Gujarat-Jamalpur - Khadia -52
6,HARUNBHAI. F. NAGORI,Aam Aadmi Party,5785,102,5887,4.62,Gujarat-Jamalpur - Khadia -52
7,MEHBUB MOHAMADBHAI RANGREJ,Independent,194,0,194,0.15,Gujarat-Jamalpur - Khadia -52
8,SARFRAJHUSEN SABIRHUSEN ANSARI,Independent,243,0,243,0.19,Gujarat-Jamalpur - Khadia -52
9,NOTA,None of the Above,1527,7,1534,1.2,Gujarat-Jamalpur - Khadia -52
1,Amul Bhatt,Bharatiya Janata Party,112527,556,113083,73.28,Gujarat-Maninagar -53
2,C.M. Rajput,Indian National Congress,22226,129,22355,14.49,Gujarat-Maninagar -53
3,Solanki Hareshkumar Hiralal,Bahujan Samaj Party,715,8,723,0.47,Gujarat-Maninagar -53
4,Ajay Rameshbhai Koshti,Jan Sangharsh Virat Party,202,4,206,0.13,Gujarat-Maninagar -53
5,Jigar Laxmanbhai Patel,Gunj Satya Ni Janata Party,605,0,605,0.39,Gujarat-Maninagar -53
6,Bhatt Sunilkumar Narendrabhai,Right to Recall Party,119,9,128,0.08,Gujarat-Maninagar -53
7,Mevada Dhaval Maheshbhai,All India Hindustan Congress Party,118,1,119,0.08,Gujarat-Maninagar -53
8,Rajendrakumar Patel,Jan Sewa Driver Party,241,2,243,0.16,Gujarat-Maninagar -53
9,Vipulbhai Patel,Aam Aadmi Party,13980,204,14184,9.19,Gujarat-Maninagar -53
10,NOTA,None of the Above,2638,22,2660,1.72,Gujarat-Maninagar -53
1,Nareshbhai Shankarbhai Vyas( Satish Vyas),Bharatiya Janata Party,55381,262,55643,35.52,Gujarat-Danilimda -54
2,Shailesh Manubhai Parmar,Indian National Congress,68906,224,69130,44.13,Gujarat-Danilimda -54
3,Kapadiya Dineshbhai Somabhai,Aam Aadmi Party,22934,317,23251,14.84,Gujarat-Danilimda -54
4,Kaushikabahen Dilipbhai Parmar,All India Majlis-E-Ittehadul Muslimeen,2464,6,2470,1.58,Gujarat-Danilimda -54
5,Chhanabhai Pashabhai Parmar,Garvi Gujarat Party,243,0,243,0.16,Gujarat-Danilimda -54
6,Nileshkumar Keshavbhai Parmar,Jan Sewa Driver Party,513,4,517,0.33,Gujarat-Danilimda -54
7,Parmar Kasturbhai Ranchhodbhai,Praja Vijay Paksh,95,0,95,0.06,Gujarat-Danilimda -54
8,Rathod Kankuben Muljibhai,SOCIAL DEMOCRATIC PARTY OF INDIA,192,1,193,0.12,Gujarat-Danilimda -54
9,Vaghela Vasantbhai Khodidas,Swatantrata Abhivyakti Party,415,1,416,0.27,Gujarat-Danilimda -54
10,Vaghela Vikrambhai Mangalbhai,Rashtriya Power Party,269,2,271,0.17,Gujarat-Danilimda -54
11,Jamnaben Sureshbhai Vegda,Independent,1492,9,1501,0.96,Gujarat-Danilimda -54
12,Sindhav Parsotambhai Gorabhai,Independent,731,7,738,0.47,Gujarat-Danilimda -54
13,NOTA,None of the Above,2163,18,2181,1.39,Gujarat-Danilimda -54
1,DINESHSINH GANPATSINH MAHIDA,Indian National Congress,21230,288,21518,13.74,Gujarat-Sabarmati -55
2,PATEL HARSHADBHAI RANCHHODBHAI (HARSHAD PATEL),Bharatiya Janata Party,119779,423,120202,76.75,Gujarat-Sabarmati -55
3,SOLANKI DIPAKBHAI MULAJIBHAI,Bahujan Samaj Party,664,1,665,0.42,Gujarat-Sabarmati -55
4,GANPATBHAI ZINABHAI SHAH,Janata Dal  (Secular),295,0,295,0.19,Gujarat-Sabarmati -55
5,GITA DAHYAJI THAKOR,Garvi Gujarat Party,236,3,239,0.15,Gujarat-Sabarmati -55
6,JASHWANTSINH VISAJI THAKOR,Aam Aadmi Party,10208,382,10590,6.76,Gujarat-Sabarmati -55
7,JIWANBHAI RAMABHAI PARMAR,Democratic Bharatiya Samaj Party,291,4,295,0.19,Gujarat-Sabarmati -55
8,NIKHILKUMAR THAKKAR,Sainik Samaj Party,162,1,163,0.1,Gujarat-Sabarmati -55
9,SHIVABHAI BABABHAI VAGHELA,Independent,363,1,364,0.23,Gujarat-Sabarmati -55
10,NOTA,None of the Above,2257,18,2275,1.45,Gujarat-Sabarmati -55
1,Darshna M. Vaghela,Bharatiya Janata Party,79550,605,80155,64.13,Gujarat-Asarwa -56
2,Vipul Parmar,Indian National Congress,25697,285,25982,20.79,Gujarat-Asarwa -56
3,Falguni R. Hadiyel,New India United Party,484,3,487,0.39,Gujarat-Asarwa -56
4,Mevada Jayantibhai Jethalal (J. J. Mevada),Aam Aadmi Party,14774,691,15465,12.37,Gujarat-Asarwa -56
5,Ravat Harishbhai Shakrabhai,Garvi Gujarat Party,536,1,537,0.43,Gujarat-Asarwa -56
6,Vankar Vasantkumar Nagjibhai (Upesh),Bhartiya Jan Parishad,283,3,286,0.23,Gujarat-Asarwa -56
7,Jagdish Shankarlal Koitiya,Independent,351,1,352,0.28,Gujarat-Asarwa -56
8,NOTA,None of the Above,1714,12,1726,1.38,Gujarat-Asarwa -56
1,UMEDJI BUDHAJI ZALA,Indian National Congress,67135,335,67470,26.69,Gujarat-Daskroi -57
2,BABUBHAI JAMNADAS PATEL (B.J.P.),Bharatiya Janata Party,158485,622,159107,62.93,Gujarat-Daskroi -57
3,KIRANKUMAR SURESHCHANDRA PATEL,Aam Aadmi Party,19085,559,19644,7.77,Gujarat-Daskroi -57
4,GOSWAMI VISHNUGIRI SOMGIRI,Praja Vijay Paksh,555,3,558,0.22,Gujarat-Daskroi -57
5,PARIHAR RAJESHSING JESINGBHAI,Garvi Gujarat Party,740,2,742,0.29,Gujarat-Daskroi -57
6,KANANI DHRUVINBHAI NARSINHBHAI,Independent,1108,3,1111,0.44,Gujarat-Daskroi -57
7,NOTA,None of the Above,4160,29,4189,1.66,Gujarat-Daskroi -57
1,ASHVINBHAI KAMSHUBHAI RATHOD,Indian National Congress,70826,542,71368,41.9,Gujarat-Dholka -58
2,KIRITSINH SARDARSANG DABHI,Bharatiya Janata Party,84213,560,84773,49.77,Gujarat-Dholka -58
3,VIDHYABEN BHAILALBHAI PANDAV,Bahujan Samaj Party,1217,12,1229,0.72,Gujarat-Dholka -58
4,JATUBHA BHURUBHA GOL,Aam Aadmi Party,4431,201,4632,2.72,Gujarat-Dholka -58
5,JADAV VIJAYKUMAR GOVINDBHAI,Log Party,139,0,139,0.08,Gujarat-Dholka -58
6,JOGADIA VINODBHAI MAVDAS,Praja Vijay Paksh,154,1,155,0.09,Gujarat-Dholka -58
7,THAKOR ARVINDKUMAR RANCHHODBHAI,Garvi Gujarat Party,2074,2,2076,1.22,Gujarat-Dholka -58
8,PATEL YOGESHKUMAR NABHUBHAI,Independent,196,0,196,0.12,Gujarat-Dholka -58
9,PARMAR VIJAYKUMAR VAJUBHAI,Independent,301,2,303,0.18,Gujarat-Dholka -58
10,RATHOD BHARATBHAI RAVJIBHAI,Independent,234,0,234,0.14,Gujarat-Dholka -58
11,RATHOD MANUBHAI KANJIBHAI,Independent,377,1,378,0.22,Gujarat-Dholka -58
12,RATHOD HASMUKHBHAI KANUBHAI,Independent,376,0,376,0.22,Gujarat-Dholka -58
13,VAGHELA RAMANBHAI KALJIBHAI,Independent,292,3,295,0.17,Gujarat-Dholka -58
14,VHORA IKRAMUDINBHAI BACHUBHAI,Independent,579,0,579,0.34,Gujarat-Dholka -58
15,VHORA SALIMBHAI ISMAILBHAI,Independent,1273,0,1273,0.75,Gujarat-Dholka -58
16,NOTA,None of the Above,2319,6,2325,1.36,Gujarat-Dholka -58
1,Kalubhai Rupabhai Dabhi,Bharatiya Janata Party,90982,546,91528,55.1,Gujarat-Dhandhuka -59
2,Jiniya Pravinbhai Mohanbhai,Bahujan Samaj Party,991,2,993,0.6,Gujarat-Dhandhuka -59
3,Gorahawa Roshaniben Prithviraj,Communist Party of India  (Marxist),489,0,489,0.29,Gujarat-Dhandhuka -59
4,Harpalsinh Jagdevsinh Chudasama,Indian National Congress,56746,456,57202,34.44,Gujarat-Dhandhuka -59
5,Ashokbhai V. Patel,Jan Sewa Driver Party,631,3,634,0.38,Gujarat-Dhandhuka -59
6,Ravjibhai Vallabhbhai Kaliya,Vyavastha Parivartan Party,380,2,382,0.23,Gujarat-Dhandhuka -59
7,Chandubhai Mansangbhai Bamroliya,Aam Aadmi Party,9605,261,9866,5.94,Gujarat-Dhandhuka -59
8,Tulashibhai Puranbhai Solanki,Right to Recall Party,370,0,370,0.22,Gujarat-Dhandhuka -59
9,Gohel Hareshkumar Arvindbhai,Bhartiya Tribal Party,643,5,648,0.39,Gujarat-Dhandhuka -59
10,Ghoghari Gullammayudin Latifbhai,Independent,464,3,467,0.28,Gujarat-Dhandhuka -59
11,Vaghela Rameshbhai Virsangbhai,Independent,626,0,626,0.38,Gujarat-Dhandhuka -59
12,NOTA,None of the Above,2886,7,2893,1.74,Gujarat-Dhandhuka -59
1,Naushad Solanki,Indian National Congress,73607,558,74165,44.26,Gujarat-Dasada -60
2,P.K.Parmar,Bharatiya Janata Party,75743,601,76344,45.56,Gujarat-Dasada -60
3,Solanki Kisanbhai Vajubhai,Bahujan Samaj Party,1039,2,1041,0.62,Gujarat-Dasada -60
4,Arvindbhai Kalubhai Solanki,Aam Aadmi Party,10060,264,10324,6.16,Gujarat-Dasada -60
5,Maheshbhai Virjibhai Rathod,Aadi Bharat Party,433,3,436,0.26,Gujarat-Dasada -60
6,Anand P Rathod,Independent,308,4,312,0.19,Gujarat-Dasada -60
7,Makwana Ukabhai Amarabhai,Independent,260,0,260,0.16,Gujarat-Dasada -60
8,Maurya Mitvardhan  Naranbhai,Independent,501,0,501,0.3,Gujarat-Dasada -60
9,R.B.Vaghela,Independent,1051,3,1054,0.63,Gujarat-Dasada -60
10,NOTA,None of the Above,3126,21,3147,1.88,Gujarat-Dasada -60
1,KIRITSINH JITUBHA RANA,Bharatiya Janata Party,80665,1100,81765,44.5,Gujarat-Limbdi -61
2,KALPANABEN BIJALBHAI DHORIYA,Indian National Congress,32443,486,32929,17.92,Gujarat-Limbdi -61
3,GABU NAGJIBHAI MOHANBHAI,Rashtra Nirman Party,839,9,848,0.46,Gujarat-Limbdi -61
4,MAYURBHAI MERABHAI SAKARIYA,Aam Aadmi Party,57529,1090,58619,31.9,Gujarat-Limbdi -61
5,RAJESH DALAL,Garvi Gujarat Party,1604,9,1613,0.88,Gujarat-Limbdi -61
6,CHAVDA MAHENDRAKUMAR MAGANBHAI,Independent,264,5,269,0.15,Gujarat-Limbdi -61
7,JAYESH HANSRAJBHAI THAKOR (TAMBOLIYA),Independent,1596,6,1602,0.87,Gujarat-Limbdi -61
8,DHORIYA RAMESHBHAI BHAVABHAI,Independent,136,1,137,0.07,Gujarat-Limbdi -61
9,PARMAR DILIPBHAI MOHANBHAI,Independent,236,7,243,0.13,Gujarat-Limbdi -61
10,MAKWANA PRAKASHBHAI PITAMBARBHAI,Independent,597,1,598,0.33,Gujarat-Limbdi -61
11,MAKVANA MAHESHBHAI MERABHAI,Independent,239,0,239,0.13,Gujarat-Limbdi -61
12,MAVJIBHAI VITHTHALBHAI PANCHALA,Independent,282,7,289,0.16,Gujarat-Limbdi -61
13,RATHOD YOGESHBHAI JETHABHAI,Independent,498,2,500,0.27,Gujarat-Limbdi -61
14,RAHULBHAI MADHABHAI ZARMARIYA,Independent,747,4,751,0.41,Gujarat-Limbdi -61
15,LAKHMANBHAI CHATURBHAI VELANI,Independent,714,1,715,0.39,Gujarat-Limbdi -61
16,NOTA,None of the Above,2602,43,2645,1.44,Gujarat-Limbdi -61
1,GADHVI TARUNBHAI BIHARIDAN,Indian National Congress,22009,376,22385,12.71,Gujarat-Wadhwan -62
2,JAGDISHBHAI PRABHUBHAI MAKWANA,Bharatiya Janata Party,104451,1452,105903,60.11,Gujarat-Wadhwan -62
3,SOLANKI PRAVINBHAI MOTIBHAI,Bahujan Samaj Party,969,36,1005,0.57,Gujarat-Wadhwan -62
4,CHAVDA NILESHBHAI MANSUKHBHAI,Rashtra Nirman Party,213,8,221,0.13,Gujarat-Wadhwan -62
5,SATVARA CHOHAN JAYESH LALJIBHAI PATRAKAR,Vyavastha Parivartan Party,302,4,306,0.17,Gujarat-Wadhwan -62
6,"""BAJRANG"" HITENDRAKUMAR BHAGVANAJIBHAI PATEL",Aam Aadmi Party,39262,1152,40414,22.94,Gujarat-Wadhwan -62
7,PARMAR BALVANTRAY LAGHARBHAI,Independent,750,2,752,0.43,Gujarat-Wadhwan -62
8,VAGHELA TULSHIBHAI SHIVABHAI,Independent,411,14,425,0.24,Gujarat-Wadhwan -62
9,BHAVANBHAI DEVJIBHAI VORA,Independent,517,7,524,0.3,Gujarat-Wadhwan -62
10,SATROTIYA VINODBHAI BABUBHAI,Independent,477,5,482,0.27,Gujarat-Wadhwan -62
11,KATIYA SALIMBHAI HARUNBHAI,Independent,871,5,876,0.5,Gujarat-Wadhwan -62
12,NOTA,None of the Above,2795,80,2875,1.63,Gujarat-Wadhwan -62
1,CHAUHAN SHAMAJIBHAI BHIMAJIBHAI,Bharatiya Janata Party,70565,474,71039,42.52,Gujarat-Chotila -63
2,BHIMABHAI POPATBHAI DABHI,Bahujan Samaj Party,1321,11,1332,0.8,Gujarat-Chotila -63
3,MAKWANA RUTVIKBHAI LAVJIBHAI,Indian National Congress,42888,444,43332,25.94,Gujarat-Chotila -63
4,KARPADA RAJUBHAI MERAMBHAI,Aam Aadmi Party,44862,535,45397,27.17,Gujarat-Chotila -63
5,JAYESH HANSRAJBHAI THAKOR(TAMBOLIYA),Independent,912,11,923,0.55,Gujarat-Chotila -63
6,JIGNESHKUMAR MALAKIYA,Independent,479,7,486,0.29,Gujarat-Chotila -63
7,MADHAR VINUBHAI RAMJIBHAI,Independent,725,2,727,0.44,Gujarat-Chotila -63
8,RATHOD VALJIBHAI BECHARBHAI,Independent,518,1,519,0.31,Gujarat-Chotila -63
9,RAYDHANBHAI GANDABHAI KUMARKHANIYA,Independent,741,1,742,0.44,Gujarat-Chotila -63
10,NOTA,None of the Above,2561,21,2582,1.55,Gujarat-Chotila -63
1,Gunjariya Chhatrasinh Shankarbhai,Indian National Congress,69561,310,69871,33.21,Gujarat-Dhrangadhra -64
2,Prakashbhai Parsotambhai  Varmora,Bharatiya Janata Party,101956,888,102844,48.88,Gujarat-Dhrangadhra -64
3,Samrat Jayraj Prabhubhai,Bahujan Samaj Party,1511,13,1524,0.72,Gujarat-Dhrangadhra -64
4,Vaghjibhai Karshanbhai  Kaila,Aam Aadmi Party,27586,541,28127,13.37,Gujarat-Dhrangadhra -64
5,Chauhan Jerambhai Govindbhai,Independent,331,2,333,0.16,Gujarat-Dhrangadhra -64
6,Parmar Kanjibhai Govindbhai,Independent,627,4,631,0.3,Gujarat-Dhrangadhra -64
7,Parmar Rajuben Ravindrabhai,Independent,194,0,194,0.09,Gujarat-Dhrangadhra -64
8,Bobda Nazirhusen Gulabbhai,Independent,185,1,186,0.09,Gujarat-Dhrangadhra -64
9,Makwana Ukabhai Amrabhai,Independent,254,2,256,0.12,Gujarat-Dhrangadhra -64
10,Makwana Govindbhai Lalabhai,Independent,316,0,316,0.15,Gujarat-Dhrangadhra -64
11,Makwana Shantilal Pamabhai,Independent,338,0,338,0.16,Gujarat-Dhrangadhra -64
12,Vijaykumar Dilipbhai Chavda,Independent,667,0,667,0.32,Gujarat-Dhrangadhra -64
13,Surela Laljibhai Khodabhai,Independent,1479,1,1480,0.7,Gujarat-Dhrangadhra -64
14,NOTA,None of the Above,3592,21,3613,1.72,Gujarat-Dhrangadhra -64
1,AMRUTIYA KANTILAL SHIVLAL,Bharatiya Janata Party,113701,837,114538,59.21,Gujarat-Morbi -65
2,KASAMBHAI HAJIBHAI SUMARA,Bahujan Samaj Party,1035,8,1043,0.54,Gujarat-Morbi -65
3,PATEL JAYANTILAL JERAJBHAI,Indian National Congress,52121,338,52459,27.12,Gujarat-Morbi -65
4,PANKAJ KANTILAL RANSARIYA,Aam Aadmi Party,17261,283,17544,9.07,Gujarat-Morbi -65
5,ASHVINKUMAR HARIBHAI TUNDIYA,Independent,274,6,280,0.14,Gujarat-Morbi -65
6,ARIFKHAN MAHMADHUSEN KHORAM,Independent,192,3,195,0.1,Gujarat-Morbi -65
7,EKBALBHAI HUSHENBHAI KATIYA,Independent,459,0,459,0.24,Gujarat-Morbi -65
8,GULAM HANIFBHAI MOVAR,Independent,235,0,235,0.12,Gujarat-Morbi -65
9,GOPAL VINUBHAI SITAPARA,Independent,113,1,114,0.06,Gujarat-Morbi -65
10,JADAV MAHESHBHAI DHANJIBHAI,Independent,164,2,166,0.09,Gujarat-Morbi -65
11,JEDA AKBAR HUSEN,Independent,174,4,178,0.09,Gujarat-Morbi -65
12,BALVANTBHAI NATHUBHAI SHEKHVA,Independent,164,2,166,0.09,Gujarat-Morbi -65
13,MADHU NIRUPABEN NATAVARLAL,Independent,277,2,279,0.14,Gujarat-Morbi -65
14,VIVEK JAYANTILAL MIRANI ALIAS(BABLUBHAI),Independent,510,0,510,0.26,Gujarat-Morbi -65
15,SHAHMADAR DAUDSHA RAHEMANSHA,Independent,425,0,425,0.22,Gujarat-Morbi -65
16,SIRAJ AMIRALI POPATIYA,Independent,2243,1,2244,1.16,Gujarat-Morbi -65
17,HASAN ALUBHAI MOVAR,Independent,1439,0,1439,0.74,Gujarat-Morbi -65
18,NOTA,None of the Above,1155,21,1176,0.61,Gujarat-Morbi -65
1,KAGATHARA LALITBHAI,Indian National Congress,72599,419,73018,40.86,Gujarat-Tankara -66
2,CHANANI MUSHABHAI ABHARAMBHAI,Bahujan Samaj Party,1666,4,1670,0.93,Gujarat-Tankara -66
3,DURLABHJIBHAI HARAKHJIBHAI DETHARIYA,Bharatiya Janata Party,82845,429,83274,46.6,Gujarat-Tankara -66
4,PARMAR SHAILESH MANUBHAI,Vyavastha Parivartan Party,906,4,910,0.51,Gujarat-Tankara -66
5,SANJAY BHATASANA (PATEL),Aam Aadmi Party,17617,217,17834,9.98,Gujarat-Tankara -66
6,NOTA,None of the Above,1979,14,1993,1.12,Gujarat-Tankara -66
1,JITENDRA KANTILAL SOMANI,Bharatiya Janata Party,80226,451,80677,39.75,Gujarat-Wankaner -67
2,BHUPENDRA KANUBHAI SAGTHIYA,Bahujan Samaj Party,932,7,939,0.46,Gujarat-Wankaner -67
3,MAHMADJAVID ABDULMUTLIB PIRZADA,Indian National Congress,60383,339,60722,29.92,Gujarat-Wankaner -67
4,AJADIA PRAKASH NARANBHAI,Rashtriya Jankranti Party,1755,2,1757,0.87,Gujarat-Wankaner -67
5,VIKRAM SORANI,Aam Aadmi Party,53110,375,53485,26.35,Gujarat-Wankaner -67
6,JEETESHBHAI RUPABHAI SANTOLA,Independent,287,0,287,0.14,Gujarat-Wankaner -67
7,NARENDRA VIRABHAI DENGADA,Independent,193,0,193,0.1,Gujarat-Wankaner -67
8,NAVINBHAI AMRUTBHAI VORA,Independent,338,4,342,0.17,Gujarat-Wankaner -67
9,MAHEBUBBHAI JAMALBHAI PIPARAVAIYA,Independent,194,0,194,0.1,Gujarat-Wankaner -67
10,MERAMBHAI KARMANBHAI  VARU,Independent,414,0,414,0.2,Gujarat-Wankaner -67
11,RAMESHBHAI LAVAJIBHAI  DABHI,Independent,524,0,524,0.26,Gujarat-Wankaner -67
12,VALLABHBHAI KARSANBHAI  VAGHELA,Independent,426,1,427,0.21,Gujarat-Wankaner -67
13,HINABEN PRAVINBHAI RAIYANI,Independent,537,1,538,0.27,Gujarat-Wankaner -67
14,NOTA,None of the Above,2446,27,2473,1.22,Gujarat-Wankaner -67
1,Indranil Rajguru,Indian National Congress,57397,162,57559,30.97,Gujarat-Rajkot East -68
2,Uday Kangad,Bharatiya Janata Party,85933,261,86194,46.38,Gujarat-Rajkot East -68
3,SAGTHIYA SURESHKUMAR GOVINDBHAI,Communist Party of India,1538,2,1540,0.83,Gujarat-Rajkot East -68
4,Rahul Bhuva,Aam Aadmi Party,35146,300,35446,19.07,Gujarat-Rajkot East -68
5,Parghi Surajbhai Nanjibhai,Independent,263,0,263,0.14,Gujarat-Rajkot East -68
6,Ranchhodbhai Maganbhai Ughreja,Independent,552,1,553,0.3,Gujarat-Rajkot East -68
7,RAJESH SAMSUDDIN  GILANI,Independent,425,0,425,0.23,Gujarat-Rajkot East -68
8,LUNAGARIYA BABULAL PARSHOTAMBHAI,Independent,1074,0,1074,0.58,Gujarat-Rajkot East -68
9,NOTA,None of the Above,2774,20,2794,1.5,Gujarat-Rajkot East -68
1,KALARIYA MANSUKHBHAI JADAVBHAI,Indian National Congress,32332,380,32712,16.03,Gujarat-Rajkot West -69
2,CHAMANBHAI SAVSANI,Bahujan Samaj Party,803,2,805,0.39,Gujarat-Rajkot West -69
3,DR. DARSHITA SHAH,Bharatiya Janata Party,137814,873,138687,67.98,Gujarat-Rajkot West -69
4,DINESHKUMAR MOHANBHAI JOSHI,Aam Aadmi Party,25769,550,26319,12.9,Gujarat-Rajkot West -69
5,PRAFULABEN R. SHIYALIYA,Log Party,224,2,226,0.11,Gujarat-Rajkot West -69
6,KIRTIKUMAR BAVANJIBHAI MARVANIYA,Independent,123,0,123,0.06,Gujarat-Rajkot West -69
7,DENGADA PRAVINBHAI MEGHJIBHAI,Independent,218,0,218,0.11,Gujarat-Rajkot West -69
8,PRASHANT CHIMANBHAI MARU,Independent,195,1,196,0.1,Gujarat-Rajkot West -69
9,BELIM SIKANDAR HUSENBHAI,Independent,115,1,116,0.06,Gujarat-Rajkot West -69
10,BHUPENDRA BHAVANBHAI PATOLIYA,Independent,169,0,169,0.08,Gujarat-Rajkot West -69
11,MAHAJAN NARENDRABHAI,Independent,160,0,160,0.08,Gujarat-Rajkot West -69
12,MEHUL NATHWANI,Independent,613,4,617,0.3,Gujarat-Rajkot West -69
13,VEGADA RAMJIBHAI GOVINDBHAI,Independent,245,0,245,0.12,Gujarat-Rajkot West -69
14,NOTA,None of the Above,3389,30,3419,1.68,Gujarat-Rajkot West -69
1,RAMESHBHAI VIRJIBHAI TILALA,Bharatiya Janata Party,101467,267,101734,66.37,Gujarat-Rajkot South -70
2,HITESH MAGANBHAI VORA,Indian National Congress,22411,96,22507,14.68,Gujarat-Rajkot South -70
3,SHIVLAL BARASIA,Aam Aadmi Party,22642,228,22870,14.92,Gujarat-Rajkot South -70
4,AMARDAS DESANI,Independent,167,1,168,0.11,Gujarat-Rajkot South -70
5,PAREKH PUNITABEN HASMUKHBHAI,Independent,2840,2,2842,1.85,Gujarat-Rajkot South -70
6,PRAVINBHAI MEGHAJIBHAI DENGADA,Independent,273,1,274,0.18,Gujarat-Rajkot South -70
7,BHUMIKA PARESHBHAI PATEL,Independent,232,0,232,0.15,Gujarat-Rajkot South -70
8,RAKESH PATEL,Independent,294,1,295,0.19,Gujarat-Rajkot South -70
9,NOTA,None of the Above,2339,14,2353,1.54,Gujarat-Rajkot South -70
1,Bathwar Sureshkumar Karshanbhai,Indian National Congress,29052,123,29175,12.81,Gujarat-Rajkot Rural -71
2,Bhanuben Manoharbhai Babariya,Bharatiya Janata Party,119353,342,119695,52.54,Gujarat-Rajkot Rural -71
3,Rahul Chavda,Bahujan Samaj Party,1619,7,1626,0.71,Gujarat-Rajkot Rural -71
4,Makwana Ranjitbhai Girdharbhai,Vyavastha Parivartan Party,453,0,453,0.2,Gujarat-Rajkot Rural -71
5,Vashrambhai Sagathiya,Aam Aadmi Party,70749,452,71201,31.25,Gujarat-Rajkot Rural -71
6,Dengada Sanjay Pravinbhai,Independent,378,0,378,0.17,Gujarat-Rajkot Rural -71
7,Babubhai Virabhai Parmar,Independent,251,0,251,0.11,Gujarat-Rajkot Rural -71
8,Babubhai Bhalabhai Babariya,Independent,514,1,515,0.23,Gujarat-Rajkot Rural -71
9,Bharatbhai Mavjibhai Chavda,Independent,397,0,397,0.17,Gujarat-Rajkot Rural -71
10,Rathod Sukhdevbhai Mohanbhai,Independent,391,0,391,0.17,Gujarat-Rajkot Rural -71
11,Solanki Ramjibhai Khimabhai,Independent,709,0,709,0.31,Gujarat-Rajkot Rural -71
12,NOTA,None of the Above,3022,16,3038,1.33,Gujarat-Rajkot Rural -71
1,KUNVARJIBHAI MOHANBHAI BAVALIYA,Bharatiya Janata Party,63347,461,63808,39.54,Gujarat-Jasdan -72
2,BHOLABHAI BHIKHABHAI GOHEL,Indian National Congress,45460,335,45795,28.38,Gujarat-Jasdan -72
3,TEJASBHAI BHIKHABHAI GAJIPARA,Aam Aadmi Party,47277,359,47636,29.52,Gujarat-Jasdan -72
4,SHAMJIBHAI AMBABHAI DANGAR (KOLI),Rashtriya Hind Ekta Dal,701,6,707,0.44,Gujarat-Jasdan -72
5,DEVRAJBHAI MASHRUBHAI MAKVANA,Independent,542,6,548,0.34,Gujarat-Jasdan -72
6,RAMABEN PRAKASHBHAI GORASVA,Independent,789,2,791,0.49,Gujarat-Jasdan -72
7,NOTA,None of the Above,2057,16,2073,1.28,Gujarat-Jasdan -72
1,Geetaba Jayrajsinh Jadeja,Bharatiya Janata Party,85359,703,86062,59.49,Gujarat-Gondal -73
2,Desai Yatish Govindlal,Indian National Congress,42585,164,42749,29.55,Gujarat-Gondal -73
3,Nimishaben Khunt,Aam Aadmi Party,12825,250,13075,9.04,Gujarat-Gondal -73
4,Mukesh Dholumal Vardhani,Independent,612,4,616,0.43,Gujarat-Gondal -73
5,NOTA,None of the Above,2148,16,2164,1.5,Gujarat-Gondal -73
1,Jayeshbhai Vitthalbhai Radadiya,Bharatiya Janata Party,106135,336,106471,60.79,Gujarat-Jetpur -74
2,Deepakbhai Keshavlal Vekariya (D.K. Vekariya),Indian National Congress,12200,44,12244,6.99,Gujarat-Jetpur -74
3,Boricha Devshibhai Kumbhabhai,Bahujan Samaj Party,1054,11,1065,0.61,Gujarat-Jetpur -74
4,Alpeshkumar V. Vadoliya (108),Right to Recall Party,386,0,386,0.22,Gujarat-Jetpur -74
5,Rajubhai Arjanbhai Sarvaiya,Samajwadi Party,20743,45,20788,11.87,Gujarat-Jetpur -74
6,Rohitbhai Vinubhai Bhuva,Aam Aadmi Party,29287,258,29545,16.87,Gujarat-Jetpur -74
7,Chavda Bharatkumar Nanjibhai,Independent,433,1,434,0.25,Gujarat-Jetpur -74
8,Jayendrasinh Govubha Chauhan,Independent,1920,3,1923,1.1,Gujarat-Jetpur -74
9,NOTA,None of the Above,2282,5,2287,1.31,Gujarat-Jetpur -74
1,Prabhat Govind Solanki,Bahujan Samaj Party,1561,16,1577,1.02,Gujarat-Dhoraji -75
2,Dr. Mahendrabhai Padalia,Bharatiya Janata Party,65871,559,66430,42.84,Gujarat-Dhoraji -75
3,Lalit Vasoya,Indian National Congress,53780,402,54182,34.95,Gujarat-Dhoraji -75
4,Vipul Sakhiya,Aam Aadmi Party,29353,441,29794,19.22,Gujarat-Dhoraji -75
5,Jafar Gani Pinjara,Independent,448,2,450,0.29,Gujarat-Dhoraji -75
6,Parmar Sahid (Hedli),Independent,466,1,467,0.3,Gujarat-Dhoraji -75
7,SIRAJBHAI ABABHAI KHEBHAR,Independent,529,0,529,0.34,Gujarat-Dhoraji -75
8,NOTA,None of the Above,1603,17,1620,1.04,Gujarat-Dhoraji -75
1,CHAVDA MEGHJIBHAI AMARABHAI,Bharatiya Janata Party,58788,504,59292,45.22,Gujarat-Kalavad -76
2,CHOUHAN MAHENDRA DINESHBHAI,Bahujan Samaj Party,1248,8,1256,0.96,Gujarat-Kalavad -76
3,PRAVIN NARASHIBHAI MUSADIYA,Indian National Congress,24159,178,24337,18.56,Gujarat-Kalavad -76
4,DR. JIGNESH SOLANKI,Aam Aadmi Party,42991,451,43442,33.13,Gujarat-Kalavad -76
5,CHAUHAN PRAVINBHAI DANABHAI,Independent,664,1,665,0.51,Gujarat-Kalavad -76
6,NOTA,None of the Above,2108,19,2127,1.62,Gujarat-Kalavad -76
1,KASAM NURMAMAD KHAFI,Bahujan Samaj Party,29133,29,29162,17.91,Gujarat-Jamnagar Rural -77
2,AHIR JIVANBHAI K. KUMBHARVADIYA,Indian National Congress,18675,62,18737,11.51,Gujarat-Jamnagar Rural -77
3,PATEL RAGHAVJIBHAI HANSRAJBHAI,Bharatiya Janata Party,79056,383,79439,48.8,Gujarat-Jamnagar Rural -77
4,PRAKASH DHIRUBHAI DONGA,Aam Aadmi Party,31656,283,31939,19.62,Gujarat-Jamnagar Rural -77
5,CHANDRA DHARMENDRA DHIRAJLAL,Independent,659,1,660,0.41,Gujarat-Jamnagar Rural -77
6,BHURALAL MEGHAJIBHAI PARMAR,Independent,550,8,558,0.34,Gujarat-Jamnagar Rural -77
7,NOTA,None of the Above,2275,10,2285,1.4,Gujarat-Jamnagar Rural -77
1,ADVOCATE JAGDISH MANSHIBHAI GADHAVI,Bahujan Samaj Party,2077,11,2088,1.36,Gujarat-Jamnagar North -78
2,BIPENDRASINH CHATURSINH JADEJA,Indian National Congress,23088,186,23274,15.14,Gujarat-Jamnagar North -78
3,RIVASINH HARDEVSINH SOLANKI (RIVABA RAVINDRASINH JADEJA),Bharatiya Janata Party,88119,716,88835,57.79,Gujarat-Jamnagar North -78
4,KARSHANBHAI KARMUR (AHIR KARSHANBHAI PARBATBHAI KARMUR),Aam Aadmi Party,34818,447,35265,22.94,Gujarat-Jamnagar North -78
5,ANVAR DAUD KAKAL,Independent,292,1,293,0.19,Gujarat-Jamnagar North -78
6,KER RAHIM OSMANBHAI,Independent,113,1,114,0.07,Gujarat-Jamnagar North -78
7,CHAVDA ASHOK NATHABHAI,Independent,130,1,131,0.09,Gujarat-Jamnagar North -78
8,JAHID AAVADBHAI JAMI,Independent,179,0,179,0.12,Gujarat-Jamnagar North -78
9,MALEK AADIL RASIDBHAI,Independent,396,2,398,0.26,Gujarat-Jamnagar North -78
10,MIYA AAMIN RAHIMBHAI,Independent,328,0,328,0.21,Gujarat-Jamnagar North -78
11,HINABEN DEPABHAI MAKWANA,Independent,375,2,377,0.25,Gujarat-Jamnagar North -78
12,NOTA,None of the Above,2419,25,2444,1.59,Gujarat-Jamnagar North -78
1,Akbari Divyeshbhai Ranchhodbhai,Bharatiya Janata Party,86045,447,86492,65.12,Gujarat-Jamnagar South -79
2,Kathiriya Manojbhai  Gordhanbhai,Indian National Congress,23730,65,23795,17.92,Gujarat-Jamnagar South -79
3,Makuben Kishorbhai Rathod (Meenaben),Bahujan Samaj Party,859,7,866,0.65,Gujarat-Jamnagar South -79
4,Kamleshkumar Jentilal Hirpara,Bharatiya National Janta Dal,200,0,200,0.15,Gujarat-Jamnagar South -79
5,Gohel Mukesh Vajubhai,Gujarat Nav Nirman Sena,260,0,260,0.2,Gujarat-Jamnagar South -79
6,Vishal Rajbal Tyagi,Aam Aadmi Party,16455,130,16585,12.49,Gujarat-Jamnagar South -79
7,Abjal Mamadbhai Bhaya,Independent,276,1,277,0.21,Gujarat-Jamnagar South -79
8,Alimamad Ishak Palani,Independent,83,0,83,0.06,Gujarat-Jamnagar South -79
9,Kadari Mahmad Hushen Aarifmiya,Independent,90,1,91,0.07,Gujarat-Jamnagar South -79
10,Chauhan Juned Abdul Rajak,Independent,1109,0,1109,0.83,Gujarat-Jamnagar South -79
11,Chauhan Bharatbhai Mohanbhai,Independent,164,2,166,0.12,Gujarat-Jamnagar South -79
12,JITESH BABUBHAI RATHOD,Independent,121,0,121,0.09,Gujarat-Jamnagar South -79
13,Pattani Chandrakant Mohanlal,Independent,205,0,205,0.15,Gujarat-Jamnagar South -79
14,Parmar Arjunbhai Karshanbhai,Independent,383,0,383,0.29,Gujarat-Jamnagar South -79
15,NOTA,None of the Above,2164,18,2182,1.64,Gujarat-Jamnagar South -79
1,Kalaria Chiragbhai Rameshbhai,Indian National Congress,13366,148,13514,8.98,Gujarat-Jamjodhpur -80
2,Chimanbhai Sapariya,Bharatiya Janata Party,60336,658,60994,40.54,Gujarat-Jamjodhpur -80
3,Ahir Hemantbhai Hardasbhai,Aam Aadmi Party,70659,738,71397,47.45,Gujarat-Jamjodhpur -80
4,Juneja Sabbirbhai Ibrahimbhai,Samajwadi Party,473,0,473,0.31,Gujarat-Jamjodhpur -80
5,Abu Umar Shida,Independent,196,1,197,0.13,Gujarat-Jamjodhpur -80
6,Ambalal Manjibhai Vavecha,Independent,260,0,260,0.17,Gujarat-Jamjodhpur -80
7,Joshi Amit Babubhai,Independent,385,1,386,0.26,Gujarat-Jamjodhpur -80
8,Pravinbhai Vallabhbhai Patel,Independent,885,2,887,0.59,Gujarat-Jamjodhpur -80
9,Basirbhai Sidikbhai Sama,Independent,801,1,802,0.53,Gujarat-Jamjodhpur -80
10,NOTA,None of the Above,1515,28,1543,1.03,Gujarat-Jamjodhpur -80
1,Ayar Mulubhai Hardasbhai Bera,Bharatiya Janata Party,77305,529,77834,40.96,Gujarat-Khambhalia -81
2,Ahir Vikrambhai Arjanbhai Maadam,Indian National Congress,44526,189,44715,23.53,Gujarat-Khambhalia -81
3,Solanki Govind Hamirbhai,Bahujan Samaj Party,994,6,1000,0.53,Gujarat-Khambhalia -81
4,Isudan Gadhvi,Aam Aadmi Party,58467,622,59089,31.1,Gujarat-Khambhalia -81
5,Chetariya Lakhubhai Lagdhirbhai,Gujarat Nav Nirman Sena,916,7,923,0.49,Gujarat-Khambhalia -81
6,Bukhari Yakub Mohammad Hushen,All India Majlis-E-Ittehadul Muslimeen,733,4,737,0.39,Gujarat-Khambhalia -81
7,Ibrahimbhai Amadbhai Ghavda,Independent,229,0,229,0.12,Gujarat-Khambhalia -81
8,Nangesh Karsan Jeshabhai,Independent,248,0,248,0.13,Gujarat-Khambhalia -81
9,Nurmamad Jusab Pariyani,Independent,612,1,613,0.32,Gujarat-Khambhalia -81
10,Manjuben Karabhai Pingal,Independent,1249,1,1250,0.66,Gujarat-Khambhalia -81
11,Vala Hamir Makvana,Independent,796,1,797,0.42,Gujarat-Khambhalia -81
12,NOTA,None of the Above,2569,13,2582,1.36,Gujarat-Khambhalia -81
1,Ahir Mulubhai Ranmalbhai Kandoriya,Indian National Congress,68275,416,68691,38.12,Gujarat-Dwarka -82
2,Pabubha Virambha Manek,Bharatiya Janata Party,73350,668,74018,41.08,Gujarat-Dwarka -82
3,Hathal Chandrasinh Sadurbha,Bahujan Samaj Party,820,1,821,0.46,Gujarat-Dwarka -82
4,Parmani Kishankumar Himantlal,Garvi Gujarat Party,1382,9,1391,0.77,Gujarat-Dwarka -82
5,Madam Nathabhai Fogabhai,Gujarat Nav Nirman Sena,595,3,598,0.33,Gujarat-Dwarka -82
6,Lakhmanbhai Boghabhai Nakum,Aam Aadmi Party,28023,358,28381,15.75,Gujarat-Dwarka -82
7,Hamir Dadu Der,Samajwadi Party,391,3,394,0.22,Gujarat-Dwarka -82
8,Asharafmiya Sidikmiya Kadri,Independent,486,0,486,0.27,Gujarat-Dwarka -82
9,Kishor Khimabhai Chavada,Independent,201,5,206,0.11,Gujarat-Dwarka -82
10,Ghediya Amit Jagdishbhai,Independent,286,3,289,0.16,Gujarat-Dwarka -82
11,Devendra Fogabha Manek,Independent,330,0,330,0.18,Gujarat-Dwarka -82
12,Nagash Karashanbhai Jeshabhai,Independent,521,5,526,0.29,Gujarat-Dwarka -82
13,Bhagvanji H. Thobhani,Independent,1149,2,1151,0.64,Gujarat-Dwarka -82
14,NOTA,None of the Above,2897,22,2919,1.62,Gujarat-Dwarka -82
1,Arjunbhai Devabhai Modhwadia,Indian National Congress,81395,661,82056,49.36,Gujarat-Porbandar -83
2,Babubhai Bhimabhai Bokhiriya,Bharatiya Janata Party,73388,487,73875,44.44,Gujarat-Porbandar -83
3,Jivan Jungi,Aam Aadmi Party,5189,130,5319,3.2,Gujarat-Porbandar -83
4,Jethabhai Bhanabhai Chavda,Bahujan Republican  Socialist Party,219,0,219,0.13,Gujarat-Porbandar -83
5,Rameshbhai Rajabhai Daki,Samajwadi Party,227,4,231,0.14,Gujarat-Porbandar -83
6,Rajesh Gaurishankar Pandya,Right to Recall Party,128,0,128,0.08,Gujarat-Porbandar -83
7,Odedara Ranmalbhai Rambhai,Independent,80,1,81,0.05,Gujarat-Porbandar -83
8,Odedara Lakhanshi Deva,Independent,307,2,309,0.19,Gujarat-Porbandar -83
9,Prakashbhai Vallabhdas Unadkat,Independent,223,2,225,0.14,Gujarat-Porbandar -83
10,Manoj Babu Buddhecha,Independent,347,0,347,0.21,Gujarat-Porbandar -83
11,Mukesh Ramji Panjari,Independent,674,0,674,0.41,Gujarat-Porbandar -83
12,NOTA,None of the Above,2738,31,2769,1.67,Gujarat-Porbandar -83
1,Dheliben Maldebhai Odedara,Bharatiya Janata Party,33532,500,34032,26.3,Gujarat-Kutiyana -84
2,Nathabhai Bhurabhai Odedara,Indian National Congress,8672,169,8841,6.83,Gujarat-Kutiyana -84
3,Kandhalbhai Sarmanbhai Jadeja,Samajwadi Party,60163,581,60744,46.94,Gujarat-Kutiyana -84
4,Butani Rajeshbhai Maganbhai,Rashtriya Hind Ekta Dal,1119,7,1126,0.87,Gujarat-Kutiyana -84
5,Bhimabhai Danabhai Makvana,Aam Aadmi Party,19273,284,19557,15.11,Gujarat-Kutiyana -84
6,Ajay Karabhai  Odedara,Independent,237,5,242,0.19,Gujarat-Kutiyana -84
7,Anand Krashnakant Buch,Independent,154,1,155,0.12,Gujarat-Kutiyana -84
8,Chandulal  Mohanbhai Rathod,Independent,344,3,347,0.27,Gujarat-Kutiyana -84
9,Nimeshbhai Mansukhbhai Bhundiya,Independent,427,3,430,0.33,Gujarat-Kutiyana -84
10,Prakashbhai Madhavjibhai Jungi,Independent,352,4,356,0.28,Gujarat-Kutiyana -84
11,Milankumar Madhavji Chauhan,Independent,333,3,336,0.26,Gujarat-Kutiyana -84
12,Mukeshbhai  Lakhaman Vaghasiya,Independent,786,2,788,0.61,Gujarat-Kutiyana -84
13,Rajeshbhai Laxmidas Madlani,Independent,484,0,484,0.37,Gujarat-Kutiyana -84
14,NOTA,None of the Above,1933,30,1963,1.52,Gujarat-Kutiyana -84
1,ARVINDBHAI JINABHAI LADANI,Indian National Congress,64253,437,64690,42.14,Gujarat-Manavadar -85
2,JAWAHARBHAI PETHALJIBHAI CHAVDA,Bharatiya Janata Party,60675,562,61237,39.89,Gujarat-Manavadar -85
3,MUCHHADIYA DEVDANBHAI KANABHAI,Bahujan Samaj Party,1343,27,1370,0.89,Gujarat-Manavadar -85
4,KARSHAN PARBAT BHADARKA (BAPU),Aam Aadmi Party,22859,438,23297,15.18,Gujarat-Manavadar -85
5,KARANGIYA PARBATBHAI BHAYABHAI,Independent,333,3,336,0.22,Gujarat-Manavadar -85
6,MAHESH PARMAR,Independent,267,1,268,0.17,Gujarat-Manavadar -85
7,RATHOD BHAVINKUMAR SHANTILAL,Independent,714,17,731,0.48,Gujarat-Manavadar -85
8,NOTA,None of the Above,1557,11,1568,1.02,Gujarat-Manavadar -85
1,JOSHI BHIKHABHAI GALABHAI,Indian National Congress,43792,568,44360,27.26,Gujarat-Junagadh -86
2,MAYURBHAI HARILAL RANVA,Bahujan Samaj Party,889,11,900,0.55,Gujarat-Junagadh -86
3,SANJAY SUKHABHAI KORADIA,Bharatiya Janata Party,83767,849,84616,52.01,Gujarat-Junagadh -86
4,GORFAD DILIPKUMAR RANCHHODBHAI,Bhartiya Jan Parishad,840,5,845,0.52,Gujarat-Junagadh -86
5,CHETANKUMAR HARSUKHBHAI GAJERA,Aam Aadmi Party,27705,601,28306,17.4,Gujarat-Junagadh -86
6,GHANSHYAMKUMAR HIMANTBHAI MASHRU,Independent,751,9,760,0.47,Gujarat-Junagadh -86
7,MAMTABEN JAYANTILAL BOTVADIYA,Independent,186,4,190,0.12,Gujarat-Junagadh -86
8,SHASHIKANT KARSHANBHAI RAVAT,Independent,343,4,347,0.21,Gujarat-Junagadh -86
9,HARESH MANUBHAI SARDHARA,Independent,378,3,381,0.23,Gujarat-Junagadh -86
10,NOTA,None of the Above,1959,43,2002,1.23,Gujarat-Junagadh -86
1,KARASHANBHAI NARANBHAI VADADORIYA,Indian National Congress,16781,182,16963,11.57,Gujarat-Visavadar -87
2,VAGHELA MANSUKHBHAI NATHABHAI,Bahujan Samaj Party,1807,35,1842,1.26,Gujarat-Visavadar -87
3,HARSHADKUMAR MADHAVJIBHAI RIBADIYA,Bharatiya Janata Party,58771,376,59147,40.36,Gujarat-Visavadar -87
4,BHUPENDRABHAI GANDUBHAI BHAYANI,Aam Aadmi Party,65675,535,66210,45.18,Gujarat-Visavadar -87
5,IKBALBHAI HABIBBHAI SAMA,Independent,630,5,635,0.43,Gujarat-Visavadar -87
6,NOTA,None of the Above,1754,11,1765,1.2,Gujarat-Visavadar -87
1,DEVABHAI PUNJABHAI MALAM,Bharatiya Janata Party,55407,395,55802,36.09,Gujarat-Keshod -88
2,HIRABHAI ARJANBHAI JOTVA,Indian National Congress,50962,632,51594,33.36,Gujarat-Keshod -88
3,ANTROLIYA DHANABHAI MUNABHAI,Vyavastha Parivartan Party,762,0,762,0.49,Gujarat-Keshod -88
4,CHUDASAMA  RAMAJIBHAI BABUBHAI,Aam Aadmi Party,23985,512,24497,15.84,Gujarat-Keshod -88
5,ARVINDBHAI KESHAVBHAI LADANI,Independent,19086,188,19274,12.46,Gujarat-Keshod -88
6,ALPESHKUMAR CHANDULAL TRAMBADIYA,Independent,376,2,378,0.24,Gujarat-Keshod -88
7,LALITKUMAR L. DEDANIYA,Independent,609,2,611,0.4,Gujarat-Keshod -88
8,NOTA,None of the Above,1706,13,1719,1.11,Gujarat-Keshod -88
1,KARGATIYA BHAGVANJIBHAI LAKHABHAI,Bharatiya Janata Party,60518,378,60896,41.21,Gujarat-Mangrol -89
2,BABUBHAI KALABHAI VAJA,Indian National Congress,38227,168,38395,25.98,Gujarat-Mangrol -89
3,HANSABEN VIJAY MAKADIYA,Bahujan Samaj Party,941,6,947,0.64,Gujarat-Mangrol -89
4,PIYUSH PARMAR,Aam Aadmi Party,33727,587,34314,23.22,Gujarat-Mangrol -89
5,SULEMANBHAI MOHMADBHAI PATEL,All India Majlis-E-Ittehadul Muslimeen,10754,35,10789,7.3,Gujarat-Mangrol -89
6,HAMIRBHAI LAKHMANBHAI DHAMA,Independent,658,7,665,0.45,Gujarat-Mangrol -89
7,NOTA,None of the Above,1751,9,1760,1.19,Gujarat-Mangrol -89
1,AMBECHADA HAMIRBHAI KARASANBHAI,Bahujan Samaj Party,1463,6,1469,0.76,Gujarat-Somnath -90
2,CHUDASAMA VIMALBHAI KANABHAI,Indian National Congress,73536,283,73819,38.2,Gujarat-Somnath -90
3,MANSINGHBHAI MERAMANBHAI PARMAR,Bharatiya Janata Party,72235,662,72897,37.72,Gujarat-Somnath -90
4,JAGMALBHAI JADAVBHAI VALA,Aam Aadmi Party,32828,407,33235,17.2,Gujarat-Somnath -90
5,ASATARBHAI AGANIBHAI PANJA,Independent,495,1,496,0.26,Gujarat-Somnath -90
6,IRFANBHAI ARAHEMANBHAI MUGAL,Independent,361,0,361,0.19,Gujarat-Somnath -90
7,ISHWARLAL KANJIBHAI SONERI,Independent,7368,13,7381,3.82,Gujarat-Somnath -90
8,MOTIVARASH DEVENDRABHAI DHANJIBHAI,Independent,877,1,878,0.45,Gujarat-Somnath -90
9,SHAH UDAY NAVINBHAI,Independent,1185,12,1197,0.62,Gujarat-Somnath -90
10,NOTA,None of the Above,1518,12,1530,0.79,Gujarat-Somnath -90
1,Dodiya Mansingbhai Jesingbhai,Indian National Congress,34110,303,34413,22.93,Gujarat-Talala -91
2,Parmar Faridaben Muradbhai,Bahujan Samaj Party,1058,10,1068,0.71,Gujarat-Talala -91
3,Bhagabhai Dhanabhai Barad,Bharatiya Janata Party,64330,458,64788,43.17,Gujarat-Talala -91
4,Solanki Devendrabhai Kanjibhai,Aam Aadmi Party,44337,396,44733,29.81,Gujarat-Talala -91
5,Abdulbhai Ismailbhai Majgul,Independent,353,1,354,0.24,Gujarat-Talala -91
6,Chandpa Karshanbhai Govindbhai,Independent,183,1,184,0.12,Gujarat-Talala -91
7,Jayeshbhai Bhagvanbhai Kamaliya,Independent,403,1,404,0.27,Gujarat-Talala -91
8,Daki Jaysukhlal Jadavbhai,Independent,1629,1,1630,1.09,Gujarat-Talala -91
9,Faijal Ibrahimbhai Dhamlot,Independent,580,1,581,0.39,Gujarat-Talala -91
10,Rafai Mahmadsha Ikbalsha,Independent,435,0,435,0.29,Gujarat-Talala -91
11,NOTA,None of the Above,1478,8,1486,0.99,Gujarat-Talala -91
1,PRADYUMAN GANUBHAI VAJA,Bharatiya Janata Party,76734,1060,77794,51.38,Gujarat-Kodinar -92
2,MAKVANA MAHESHBHAI JETHABHAI,Indian National Congress,57968,440,58408,38.58,Gujarat-Kodinar -92
3,SOSA BALUBHAI PITHABHAI,Bahujan Samaj Party,1089,6,1095,0.72,Gujarat-Kodinar -92
4,VALJIBHAI KARSHANBHAI MAKVANA,Aam Aadmi Party,10451,287,10738,7.09,Gujarat-Kodinar -92
5,VADHEL DIPSINH GOVINDBHAI,Independent,1345,8,1353,0.89,Gujarat-Kodinar -92
6,NOTA,None of the Above,2013,12,2025,1.34,Gujarat-Kodinar -92
1,KALUBHAI CHANABHAI RATHOD,Bharatiya Janata Party,95356,504,95860,56.46,Gujarat-Una -93
2,VANSH PUNJABHAI BHIMABHAI,Indian National Congress,52015,319,52334,30.83,Gujarat-Una -93
3,ISHWAR RAMBHAI SOLANKI,Right to Recall Party,1074,4,1078,0.63,Gujarat-Una -93
4,PANCHABHAI BHAYABHAI DAMANIYA,Bharatiya Hitrakshak Party,1122,5,1127,0.66,Gujarat-Una -93
5,SHANTILAL DANABHAI KIDECHA,Rashtriya Samaj Dal (R),355,1,356,0.21,Gujarat-Una -93
6,SEJALBEN MANSUKHBHAI KHUNT,Aam Aadmi Party,12727,195,12922,7.61,Gujarat-Una -93
7,GOHIL MANSINH BALUBHAI,Independent,680,7,687,0.4,Gujarat-Una -93
8,NILESH ANILBHAI KHORASEE,Independent,367,2,369,0.22,Gujarat-Una -93
9,VALA BHANAJIBHAI KHETABHAI,Independent,803,3,806,0.47,Gujarat-Una -93
10,VANSH BALUBHAI KARSHANBHAI,Independent,1142,0,1142,0.67,Gujarat-Una -93
11,NOTA,None of the Above,3085,7,3092,1.82,Gujarat-Una -93
1,KAKADIYA JAYSUKHBHAI VALLABHBHAI (KAKADIYA J.V.),Bharatiya Janata Party,45954,512,46466,39,Gujarat-Dhari -94
2,KIRTIKUMAR KANUBHAI BORISAGAR,Indian National Congress,17708,270,17978,15.09,Gujarat-Dhari -94
3,PAYAL BHAVIN PATEL,Janata Dal  (Secular),2233,9,2242,1.88,Gujarat-Dhari -94
4,BHUPATBHAI CHHAGANBHAI UNAVA,Vyavastha Parivartan Party,876,5,881,0.74,Gujarat-Dhari -94
5,VIJAYBHAI AMRUTBHAI CHAVDA,Log Party,372,2,374,0.31,Gujarat-Dhari -94
6,SATASIYA KANTIBHAI SHAMBHUBHAI,Aam Aadmi Party,37341,408,37749,31.68,Gujarat-Dhari -94
7,SURESHBHAI DILUBHAI PARMAR,Rashtriya Power Party,375,2,377,0.32,Gujarat-Dhari -94
8,SOJITRA HITESHBHAI GOBARBHAI,Rashtriya Hind Ekta Dal,259,1,260,0.22,Gujarat-Dhari -94
9,CHATURBHAI PARSHOTAMBHAI RUDANI,Independent,666,2,668,0.56,Gujarat-Dhari -94
10,PARMAR IMRANBHAI VALIBHAI,Independent,681,1,682,0.57,Gujarat-Dhari -94
11,VALA UPENDRABHAI VALKUBHAI,Independent,9530,95,9625,8.08,Gujarat-Dhari -94
12,NOTA,None of the Above,1830,15,1845,1.55,Gujarat-Dhari -94
1,KAUSHIK KANTIBHAI VEKARIYA,Bharatiya Janata Party,88004,1030,89034,54.89,Gujarat-Amreli -95
2,DHANANI PARESHKUMAR DHIRAJLAL,Indian National Congress,41859,518,42377,26.12,Gujarat-Amreli -95
3,GOHIL MUKESHBHAI KHIMAJIBHAI,Vyavastha Parivartan Party,834,2,836,0.52,Gujarat-Amreli -95
4,RAVI DHANANI,Aam Aadmi Party,26106,339,26445,16.3,Gujarat-Amreli -95
5,VINUBHAI CHAVADA,Independent,1382,3,1385,0.85,Gujarat-Amreli -95
6,NOTA,None of the Above,2112,26,2138,1.32,Gujarat-Amreli -95
1,JANAKBHAI TALAVIYA,Bharatiya Janata Party,64465,401,64866,49.12,Gujarat-Lathi -96
2,VIRJIBHAI THUMMAR,Indian National Congress,35390,202,35592,26.95,Gujarat-Lathi -96
3,JAGDISHCHANDRA MAYANI,Vyavastha Parivartan Party,935,4,939,0.71,Gujarat-Lathi -96
4,J.R.PARMAR,Right to Recall Party,399,3,402,0.3,Gujarat-Lathi -96
5,JAYSHUKHBHAI RAVAJIBHAI DETROJA (DOLI),Aam Aadmi Party,26431,212,26643,20.17,Gujarat-Lathi -96
6,DILABHAI KOREJA,Independent,776,3,779,0.59,Gujarat-Lathi -96
7,MUNABHAI NAKUBHAI BAVALIYA,Independent,799,0,799,0.61,Gujarat-Lathi -96
8,NOTA,None of the Above,2028,12,2040,1.54,Gujarat-Lathi -96
1,KASWALA MAHESH,Bharatiya Janata Party,63447,310,63757,46.01,Gujarat-Savarkundla -97
2,GEETABEN NAJABHAI MARU,Bahujan Samaj Party,955,3,958,0.69,Gujarat-Savarkundla -97
3,PRATAP DUDHAT,Indian National Congress,59945,320,60265,43.49,Gujarat-Savarkundla -97
4,NANALAL KALIDAS MAHETA,Rashtriya Samaj Dal (R),537,2,539,0.39,Gujarat-Savarkundla -97
5,BHARAT NAKARANI,Aam Aadmi Party,7754,141,7895,5.7,Gujarat-Savarkundla -97
6,MAKVANA BHARATBHAI KALUBHAI,Vyavastha Parivartan Party,225,0,225,0.16,Gujarat-Savarkundla -97
7,KISHOR BAGADA,Independent,267,1,268,0.19,Gujarat-Savarkundla -97
8,YUNUSBHAI DOLABHAI JADAV,Independent,235,0,235,0.17,Gujarat-Savarkundla -97
9,SHABBIRBHAI ALARAKHBHAI MALEK (PINTUBHAI MALEK),Independent,379,0,379,0.27,Gujarat-Savarkundla -97
10,SAIYAD NAUSHAD RAHIMMIYA KADRI,Independent,883,3,886,0.64,Gujarat-Savarkundla -97
11,HAKU VALA,Independent,651,4,655,0.47,Gujarat-Savarkundla -97
12,NOTA,None of the Above,2506,14,2520,1.82,Gujarat-Savarkundla -97
1,AMBARISHKUMAR JIVABHAI DER,Indian National Congress,67536,483,68019,37.87,Gujarat-Rajula -98
2,HIRABHAI ODHAVJIBHAI SOLANKI,Bharatiya Janata Party,77933,549,78482,43.69,Gujarat-Rajula -98
3,GAHA MAJIDBHAI,SOCIAL DEMOCRATIC PARTY OF INDIA,961,17,978,0.54,Gujarat-Rajula -98
4,CHAMPUBHAI DHAKHADA,Gujarat Nav Nirman Sena,594,4,598,0.33,Gujarat-Rajula -98
5,BHARATKUMAR BALDANIYA,Aam Aadmi Party,5202,92,5294,2.95,Gujarat-Rajula -98
6,KARANBHAI BARAIYA,Independent,19083,103,19186,10.68,Gujarat-Rajula -98
7,GITABEN BHARATKUMAR PARMAR,Independent,210,2,212,0.12,Gujarat-Rajula -98
8,CHAMPABEN NARSHIBHAI RATHOD,Independent,166,0,166,0.09,Gujarat-Rajula -98
9,PUSPABEN  KAMLESHBHAI PARMAR,Independent,225,2,227,0.13,Gujarat-Rajula -98
10,MUKTABEN NARENDRABHAI PARMAR,Independent,227,2,229,0.13,Gujarat-Rajula -98
11,RAJESHBHAI NATUBHAI JOSHI,Independent,352,2,354,0.2,Gujarat-Rajula -98
12,VAGH SHIVABHAI BHANABHAI,Independent,363,1,364,0.2,Gujarat-Rajula -98
13,VAGH HARSURBHAI VALERABHAI,Independent,622,2,624,0.35,Gujarat-Rajula -98
14,VIJYABEN GIRISHBHAI PARMAR,Independent,563,0,563,0.31,Gujarat-Rajula -98
15,SHWETABEN BUDHABHAI VAGHELA,Independent,1493,3,1496,0.83,Gujarat-Rajula -98
16,NOTA,None of the Above,2820,9,2829,1.57,Gujarat-Rajula -98
1,DR. KANUBHAI V. KALSARIA,Indian National Congress,55469,522,55991,36.22,Gujarat-Mahuva -99
2,GOHIL SHIVABHAI JERAMBHAI,Bharatiya Janata Party,85977,486,86463,55.92,Gujarat-Mahuva -99
3,ASHOKBHAI MANGALBHAI JOLIYA,Aam Aadmi Party,5983,94,6077,3.93,Gujarat-Mahuva -99
4,SOLANKI ARVINDBHAI NATHABHAI,Rashtriya Hind Ekta Dal,366,2,368,0.24,Gujarat-Mahuva -99
5,SANKHAT SAVJIBHAI BHAGVANBHAI (KOLI SAVARAM SANKHAT),Vyavastha Parivartan Party,510,6,516,0.33,Gujarat-Mahuva -99
6,ALIMAHAMAD HANIFBHAI HALARI,Independent,243,1,244,0.16,Gujarat-Mahuva -99
7,GOPALBHAI GABHABHAI JOLIYA,Independent,358,0,358,0.23,Gujarat-Mahuva -99
8,NANJIBHAI HARASURBHAI BARAIYA (NANJIBHAI BARAIYA),Independent,404,2,406,0.26,Gujarat-Mahuva -99
9,MAHEBUBBHAI ALARAKHBHAI SHEKH,Independent,539,1,540,0.35,Gujarat-Mahuva -99
10,HOJEFA IKBALBHAI HINGORA,Independent,1025,0,1025,0.66,Gujarat-Mahuva -99
11,NOTA,None of the Above,2612,7,2619,1.69,Gujarat-Mahuva -99
1,KANUBHAI MATHURAMBHAI BARAIYA (KANUBHAI BARAIYA),Indian National Congress,45893,1056,46949,29.97,Gujarat-Talaja -100
2,GAUTAMBHAI GOPABHAI CHAUHAN,Bharatiya Janata Party,89575,680,90255,57.62,Gujarat-Talaja -100
3,LALUBEN NARASHIBHAI CHAUHAN,Aam Aadmi Party,12397,330,12727,8.13,Gujarat-Talaja -100
4,ANOPSINH GULABSINH GOHIL,Independent,353,11,364,0.23,Gujarat-Talaja -100
5,KARMASHI MAVJIBHAI JABUCHA,Independent,421,3,424,0.27,Gujarat-Talaja -100
6,KACHALIA NAZIRBHAI IBRAHIMBHAI,Independent,343,0,343,0.22,Gujarat-Talaja -100
7,CHAUHAN SUNILBHAI KHODABHAI,Independent,365,4,369,0.24,Gujarat-Talaja -100
8,JAYANTIBHAI RAJABHAI MAKVANA,Independent,488,10,498,0.32,Gujarat-Talaja -100
9,JILUBHAI GIGABHAI BHAMMAR (AHIR),Independent,534,11,545,0.35,Gujarat-Talaja -100
10,HARIBHAI BHIMABHAI RATHOD,Independent,1684,0,1684,1.08,Gujarat-Talaja -100
11,NOTA,None of the Above,2452,30,2482,1.58,Gujarat-Talaja -100
1,KANTARIYA KISHORBHAI PALJIBHAI,Bahujan Samaj Party,914,2,916,0.65,Gujarat-Gariadhar -101
2,CHAVADA DIVYESHBHAI MANUBHAI,Indian National Congress,14967,132,15099,10.77,Gujarat-Gariadhar -101
3,NAKRANI KESHUBHAI HIRJIBHAI,Bharatiya Janata Party,55773,352,56125,40.03,Gujarat-Gariadhar -101
4,CHAVADA GHANSHYAMBHAI ASHOKBHAI,Rashtriya Hind Ekta Dal,2311,5,2316,1.65,Gujarat-Gariadhar -101
5,BHUPATBHAI MOHANBHAI VALA,Right to Recall Party,558,6,564,0.4,Gujarat-Gariadhar -101
6,SUDHIRBHAI VAGHANI (SUDHIR VAGHANI),Aam Aadmi Party,60463,481,60944,43.46,Gujarat-Gariadhar -101
7,SONRAT LAKHUBHAI JETHSURBHAI,Rashtriya Power Party,483,0,483,0.34,Gujarat-Gariadhar -101
8,GAUSWAMI PIYUSHGIRI HASMUKHGIRI,Independent,757,6,763,0.54,Gujarat-Gariadhar -101
9,BAMBHANIYA VALLABHBHAI RATNABHAI,Independent,860,4,864,0.62,Gujarat-Gariadhar -101
10,RAHULBHAI VITHTHALBHAI RAVAL,Independent,655,1,656,0.47,Gujarat-Gariadhar -101
11,NOTA,None of the Above,1482,9,1491,1.06,Gujarat-Gariadhar -101
1,PARMAR NARESHBHAI RAVJIBHAI,Bahujan Samaj Party,1388,7,1395,0.83,Gujarat-Palitana -102
2,BHIKHABHAI RAVAJIBHAI BARAIYA,Bharatiya Janata Party,80759,809,81568,48.77,Gujarat-Palitana -102
3,RATHOD PRAVINBHAI JINABHAI,Indian National Congress,53359,632,53991,32.28,Gujarat-Palitana -102
4,KHENI JINABHAI PARSHOTTAMBHAI (Dr.Z.P. KHENI),Aam Aadmi Party,24569,450,25019,14.96,Gujarat-Palitana -102
5,GOHIL SANJAYBHAI VALAJIBHAI,Vyavastha Parivartan Party,881,5,886,0.53,Gujarat-Palitana -102
6,IBRAHIMBHAI HASANALI SAIYAD,Independent,905,4,909,0.54,Gujarat-Palitana -102
7,NARSHIBHAI UKABHAI CHAUHAN,Independent,1547,10,1557,0.93,Gujarat-Palitana -102
8,NOTA,None of the Above,1901,29,1930,1.15,Gujarat-Palitana -102
1,GOHIL REVATSINH BATUKBHA(HOIDAD),Indian National Congress,42096,454,42550,23.33,Gujarat-Bhavnagar Rural -103
2,PARSHOTTAMBHAI O. SOLANKI,Bharatiya Janata Party,114974,1060,116034,63.61,Gujarat-Bhavnagar Rural -103
3,MAKWANA ASHOKBHAI GOBARBHAI,Bahujan Samaj Party,1239,16,1255,0.69,Gujarat-Bhavnagar Rural -103
4,GOHIL KHUMANSINH NATUBHA,Aam Aadmi Party,16824,412,17236,9.45,Gujarat-Bhavnagar Rural -103
5,PARMAR RAJESHKUMAR P.,Rashtriya Hind Ekta Dal,1418,3,1421,0.78,Gujarat-Bhavnagar Rural -103
6,HEMANTSINH KARANSINH GOHIL(HEMBHA),Independent,991,3,994,0.54,Gujarat-Bhavnagar Rural -103
7,NOTA,None of the Above,2882,35,2917,1.6,Gujarat-Bhavnagar Rural -103
1,ARUN MEHTA,Communist Party of India  (Marxist),1791,8,1799,1.11,Gujarat-Bhavnagar East -104
2,KISHORSINH BHARATSINH GOHIL,Bahujan Samaj Party,534,7,541,0.33,Gujarat-Bhavnagar East -104
3,BALDEV MAVJIBHAI SOLANKI,Indian National Congress,35909,244,36153,22.23,Gujarat-Bhavnagar East -104
4,SEJALBEN RAJIVKUMAR PANDYA,Bharatiya Janata Party,98223,484,98707,60.71,Gujarat-Bhavnagar East -104
5,DHARAMSHIBHAI RAMJIBHAI DHAPA,Vyavastha Parivartan Party,1769,12,1781,1.1,Gujarat-Bhavnagar East -104
6,MRUDANGRAJSINH MULRAJSINH CHUDASAMA,Right to Recall Party,511,4,515,0.32,Gujarat-Bhavnagar East -104
7,HAMIR RATHOD (MASTER),Aam Aadmi Party,19546,265,19811,12.18,Gujarat-Bhavnagar East -104
8,HARSH JAGDISHBHAI GOKLANI,Independent,493,0,493,0.3,Gujarat-Bhavnagar East -104
9,NOTA,None of the Above,2769,27,2796,1.72,Gujarat-Bhavnagar East -104
1,KISHORSINH KUMBHAJIBHAI GOHIL (K. K. GOHIL),Indian National Congress,42791,475,43266,26.77,Gujarat-Bhavnagar West -105
2,JITENDRABHAI SAVAJIBHAI VAGHANI (JITU VAGHANI),Bharatiya Janata Party,84713,475,85188,52.7,Gujarat-Bhavnagar West -105
3,DINESHBHAI LAKHABHAI RATHOD,Bahujan Samaj Party,667,7,674,0.42,Gujarat-Bhavnagar West -105
4,MANHARBHAI KANJIBHAI RATHOD,Communist Party of India  (Marxist),250,1,251,0.16,Gujarat-Bhavnagar West -105
5,SHEKH YUNUSBHAI MOHAMED ZAKARIYA,Communist Party of India,461,0,461,0.29,Gujarat-Bhavnagar West -105
6,BARAIYA GOBARBHAI KANJIBHAI,Vyavastha Parivartan Party,286,0,286,0.18,Gujarat-Bhavnagar West -105
7,RAJENBHAI SHANKARBHAI SOLANKI (RAJU SOLANKI),Aam Aadmi Party,26036,372,26408,16.34,Gujarat-Bhavnagar West -105
8,GOPAL NAJABHAI BOLIYA,Independent,204,0,204,0.13,Gujarat-Bhavnagar West -105
9,JAYABEN MEHULBHAI BORICHA,Independent,184,1,185,0.11,Gujarat-Bhavnagar West -105
10,MANSUKHBHAI MALUBHAI SOLANKI (MANALAL),Independent,511,1,512,0.32,Gujarat-Bhavnagar West -105
11,YASMINBEN DILAVRBHAI MALEK,Independent,301,0,301,0.19,Gujarat-Bhavnagar West -105
12,RATHOD  ASHOKBHAI GAMBHIRBHAI,Independent,224,0,224,0.14,Gujarat-Bhavnagar West -105
13,SARFRAJ RUSTAMBHAI KURESHI,Independent,216,0,216,0.13,Gujarat-Bhavnagar West -105
14,SOLANKI RAJESHBHAI SHANTILAL (RAJUBHAI SOLANKI),Independent,370,1,371,0.23,Gujarat-Bhavnagar West -105
15,SOLANKI SAVITABEN RAMESHBHAI,Independent,686,0,686,0.42,Gujarat-Bhavnagar West -105
16,NOTA,None of the Above,2374,43,2417,1.5,Gujarat-Bhavnagar West -105
1,Jagdishkumar Motilal Chavda,Indian National Congress,29631,268,29899,21.93,Gujarat-Gadhada -106
2,Mahant Shambhunath Tundiya,Bharatiya Janata Party,63616,770,64386,47.22,Gujarat-Gadhada -106
3,Solanki Babubhai Khimjibhai,Bahujan Samaj Party,1373,15,1388,1.02,Gujarat-Gadhada -106
4,Parmar Rameshbhai Parbhubhai,Aam Aadmi Party,37090,602,37692,27.64,Gujarat-Gadhada -106
5,Rajeshbhai Polabhai Parmar,Bhartiya Tribal Party,955,2,957,0.7,Gujarat-Gadhada -106
6,NOTA,None of the Above,1997,34,2031,1.49,Gujarat-Gadhada -106
1,GHANSHYAMBHAI PRAGJIBHAI VIRANI,Bharatiya Janata Party,77049,753,77802,41.56,Gujarat-Botad -107
2,CHAUHAN MULSHANKARBHAI RAGHURAMBHAI,Bahujan Samaj Party,1049,8,1057,0.56,Gujarat-Botad -107
3,MANHARBHAI NAGAJIBHAI PATEL,Indian National Congress,18775,283,19058,10.18,Gujarat-Botad -107
4,CHAUHAN KAMLESHBHAI ARJANBHAI,Vyavastha Parivartan Party,453,4,457,0.24,Gujarat-Botad -107
5,DHADHAL AMIRAJSINH JAGUBHAI,Praja Vijay Paksh,476,1,477,0.25,Gujarat-Botad -107
6,MAKWANA UMESHBHAI NARANBHAI,Aam Aadmi Party,79524,1057,80581,43.04,Gujarat-Botad -107
7,MORADIYA NITESHBHAI PURUSHOTAMBHAI,Right to Recall Party,369,0,369,0.2,Gujarat-Botad -107
8,ALPABALA DILIPKUMAR SABVA,Independent,348,14,362,0.19,Gujarat-Botad -107
9,KHAMBHALIYA KISHORBHAI RAMNIKBHAI,Independent,260,9,269,0.14,Gujarat-Botad -107
10,CHAUHAN CHAMPABEN ZAVERBHAI,Independent,2031,2,2033,1.09,Gujarat-Botad -107
11,PATEL SANJAYBHAI JADAVBHAI,Independent,387,4,391,0.21,Gujarat-Botad -107
12,BAVALIYA JAYESHBHAI BHAGVANBHAI,Independent,556,2,558,0.3,Gujarat-Botad -107
13,MITHAPARA MUKESHKUMAR BABUBHAI,Independent,584,2,586,0.31,Gujarat-Botad -107
14,MEGHJIBHAI VITHALBHAI TALSANIYA,Independent,770,12,782,0.42,Gujarat-Botad -107
15,NOTA,None of the Above,2405,28,2433,1.3,Gujarat-Botad -107
1,CHIRAGKUMAR ARVINDBHAI PATEL,Indian National Congress,68642,427,69069,43.53,Gujarat-Khambhat -108
2,BHAILALBHAI KALUBHAI PANDAV,Bahujan Samaj Party,1020,2,1022,0.64,Gujarat-Khambhat -108
3,MAHESHKUMAR KANAIYALAL RAVAL (MAYUR RAVAL),Bharatiya Janata Party,65073,285,65358,41.19,Gujarat-Khambhat -108
4,ARUNKUMAR KABHAIBHAI GOHIL,Aam Aadmi Party,2468,46,2514,1.58,Gujarat-Khambhat -108
5,PATEL  KRUNALKUMAR JASVANTBHAI,Rashtriya Hind Ekta Dal,181,1,182,0.11,Gujarat-Khambhat -108
6,PATEL RONITKUMAR ASHOKBHAI,Pachchasi Parivartan Samaj Party,196,0,196,0.12,Gujarat-Khambhat -108
7,AMARSINH RAMSINH ZALA (NOTARY ADVOCATE),Independent,3953,15,3968,2.5,Gujarat-Khambhat -108
8,AMBALIYA RANJITBHAI KEHUBHAI,Independent,2574,5,2579,1.63,Gujarat-Khambhat -108
9,CHAUHAN MAHIPATSINH KESARISINH,Independent,9454,60,9514,6,Gujarat-Khambhat -108
10,VISHNUBHAI RATILAL CHUNARA,Independent,1039,1,1040,0.66,Gujarat-Khambhat -108
11,SINDHA RAJENDRASINH MAHOBATSINH (BAPU),Independent,623,4,627,0.4,Gujarat-Khambhat -108
12,NOTA,None of the Above,2585,5,2590,1.63,Gujarat-Khambhat -108
1,Ahir Ankurbhai Kanubhai,Bahujan Samaj Party,2027,4,2031,1.11,Gujarat-Borsad -109
2,Parmar Rajendrasinh Dhirsinh,Indian National Congress,80061,546,80607,44.23,Gujarat-Borsad -109
3,Solanki Ramanbhai Bhikhabhai,Bharatiya Janata Party,91320,452,91772,50.35,Gujarat-Borsad -109
4,Sureshbhai Ravjibhai Thakor,Log Party,746,0,746,0.41,Gujarat-Borsad -109
5,Patel Manishbhai Ramanbhai,Aam Aadmi Party,1964,39,2003,1.1,Gujarat-Borsad -109
6,Patel Dipenkumar Niranjanbhai,Independent,358,0,358,0.2,Gujarat-Borsad -109
7,Parmar Kesharisinh Bharatsinh,Independent,883,1,884,0.49,Gujarat-Borsad -109
8,Bhoi Ashishkumar Thakorbhai,Independent,1760,0,1760,0.97,Gujarat-Borsad -109
9,NOTA,None of the Above,2090,3,2093,1.15,Gujarat-Borsad -109
1,AMIT CHAVDA,Indian National Congress,81289,223,81512,48.71,Gujarat-Anklav -110
2,GULABSINH RATANSINH PADHIYAR,Bharatiya Janata Party,78586,197,78783,47.07,Gujarat-Anklav -110
3,BIPINBHAI MANILAL BHETASIYA,Bahujan Samaj Party,788,0,788,0.47,Gujarat-Anklav -110
4,GAJENDRASINH HARISINH RAJ,Aam Aadmi Party,1582,21,1603,0.96,Gujarat-Anklav -110
5,RAJ YUSUFBHAI ABHESANG (GARASIYA),Rashtriya Hind Ekta Dal,228,1,229,0.14,Gujarat-Anklav -110
6,KEYUR PRAVINBHAI PATEL,Independent,398,0,398,0.24,Gujarat-Anklav -110
7,RAJ AJITSINH CHANDRASINH,Independent,1352,1,1353,0.81,Gujarat-Anklav -110
8,NOTA,None of the Above,2689,3,2692,1.61,Gujarat-Anklav -110
1,Govindbhai Raijibhai Parmar,Bharatiya Janata Party,95335,304,95639,51.32,Gujarat-Umreth -111
2,Jayant Patel(Boskey),Nationalist Congress Party,68538,384,68922,36.99,Gujarat-Umreth -111
3,Amrishbhai Hemendrabhai Patel(Thamna),Aam Aadmi Party,3854,94,3948,2.12,Gujarat-Umreth -111
4,Vipulkumar A. Zala,Log Party,485,2,487,0.26,Gujarat-Umreth -111
5,Jagdishbhai Ravjibhai Thakor,Independent,5402,13,5415,2.91,Gujarat-Umreth -111
6,Zala Rameshbhai Ramabhai (Lalabhai),Independent,2417,6,2423,1.3,Gujarat-Umreth -111
7,Darji Ghanshyambhai Natvarbhai,Independent,197,0,197,0.11,Gujarat-Umreth -111
8,Najimkhan Fakirmahmnad Pathan,Independent,201,2,203,0.11,Gujarat-Umreth -111
9,Baldevsinh Udesinh Parmar (B.U.),Independent,2127,8,2135,1.15,Gujarat-Umreth -111
10,Sadru U. Belim,Independent,320,0,320,0.17,Gujarat-Umreth -111
11,Harshitkumar Ghanshyambhai Patel (Bhurabhai),Independent,1053,1,1054,0.57,Gujarat-Umreth -111
12,Hidayatullakhan Fakirmahamadkhan Pathan,Independent,1740,1,1741,0.93,Gujarat-Umreth -111
13,NOTA,None of the Above,3848,9,3857,2.07,Gujarat-Umreth -111
1,ALPESHKUMAR JAYANTIBHAI MAKWANA (APPU),Bahujan Samaj Party,1331,13,1344,0.69,Gujarat-Anand -112
2,KANTIBHAI SODHA PARMAR (BHAGAT),Indian National Congress,69656,580,70236,36.22,Gujarat-Anand -112
3,YOGESH R. PATEL (BAPJI),Bharatiya Janata Party,111226,633,111859,57.68,Gujarat-Anand -112
4,ARVINDKUMAR AMARSHIBHAI GOL,Rashtriya Hind Ekta Dal,581,0,581,0.3,Gujarat-Anand -112
5,MAULIK VINUBHAI SHAH,Bharatiya National Janta Dal,209,1,210,0.11,Gujarat-Anand -112
6,VAGHARI GANPATBHAI JESANGBHAI,Log Party,98,0,98,0.05,Gujarat-Anand -112
7,SEDALIYA  GIRISHKUMAR HIMMATLAL,Aam Aadmi Party,4852,219,5071,2.61,Gujarat-Anand -112
8,JANKIBEN DINESHBHAI PATEL,Independent,119,3,122,0.06,Gujarat-Anand -112
9,TOFIKMIYA FAKRUMIYA MALEK,Independent,212,1,213,0.11,Gujarat-Anand -112
10,TOSIFBHAI MUSTUFABHAI VHORA (HAFEJI),Independent,309,0,309,0.16,Gujarat-Anand -112
11,DAVE JATINKUMAR DINESHCHANDRA,Independent,128,1,129,0.07,Gujarat-Anand -112
12,PARMAR PRATIMABEN SHAILESHBHAI,Independent,187,0,187,0.1,Gujarat-Anand -112
13,VIJAYBHAI SHANTILAL JADAV,Independent,236,0,236,0.12,Gujarat-Anand -112
14,VIPULKUMAR BIPINBHAI MACWAN,Independent,616,8,624,0.32,Gujarat-Anand -112
15,SARFARAJ HUSENKHAN PATHAN (S.K),Independent,547,1,548,0.28,Gujarat-Anand -112
16,NOTA,None of the Above,2126,31,2157,1.11,Gujarat-Anand -112
1,Kamleshbhai Rameshbhai Patel (Master),Bharatiya Janata Party,88787,379,89166,52.3,Gujarat-Petlad -113
2,Dr. Prakash Budhabhai Parmar (Doctor),Indian National Congress,70804,408,71212,41.77,Gujarat-Petlad -113
3,Harshadbhai Ishvarbhai Gohel,Bahujan Samaj Party,753,2,755,0.44,Gujarat-Petlad -113
4,Arjunbhai Sidhabhai Bharwad,Aam Aadmi Party,4537,59,4596,2.7,Gujarat-Petlad -113
5,Talpada Somabhai Zenabhai,Right to Recall Party,225,0,225,0.13,Gujarat-Petlad -113
6,Shah Yatrikbhai Harishbhai (Maharaj),Rashtriya Hind Ekta Dal,313,0,313,0.18,Gujarat-Petlad -113
7,Thakor Sanjaykumar Viththalbhai,Independent,845,0,845,0.5,Gujarat-Petlad -113
8,Pathan Riyajkhan Akbarkhan,Independent,928,1,929,0.54,Gujarat-Petlad -113
9,NOTA,None of the Above,2432,2,2434,1.43,Gujarat-Petlad -113
1,PATEL VIPULKUMAR VINUBHAI,Bharatiya Janata Party,86977,323,87300,56.47,Gujarat-Sojitra -114
2,POONAMBHAI MADHABHAI PARMAR,Indian National Congress,57513,268,57781,37.37,Gujarat-Sojitra -114
3,MUKESHBHAI RANCHHODBHAI JADAVA,Bahujan Samaj Party,1286,2,1288,0.83,Gujarat-Sojitra -114
4,MANUBHAI RANCHHODBHAI THAKOR,Aam Aadmi Party,3375,85,3460,2.24,Gujarat-Sojitra -114
5,GOHIL YUVRAJSINH MAHIPATSINH,Independent,210,2,212,0.14,Gujarat-Sojitra -114
6,JAVEDBHAI  RAJAKBHAI VAHORA (MUKHI GASVALA),Independent,313,1,314,0.2,Gujarat-Sojitra -114
7,DEVANGKUMAR NARHARILAL SHELAT (DEVO),Independent,571,4,575,0.37,Gujarat-Sojitra -114
8,MANUBHAI JETHABHAI VANKAR,Independent,908,0,908,0.59,Gujarat-Sojitra -114
9,NOTA,None of the Above,2756,10,2766,1.79,Gujarat-Sojitra -114
1,Kalpeshbhai Ashabhai Parmar,Bharatiya Janata Party,83851,444,84295,47.45,Gujarat-Matar -115
2,Sanjaybhai Haribhai Patel,Indian National Congress,67827,617,68444,38.53,Gujarat-Matar -115
3,Bamba Togabhai Punambhai,Gujarat Nav Nirman Sena,1382,9,1391,0.78,Gujarat-Matar -115
4,Laljibhai Melabhai Parmar,Aam Aadmi Party,1470,84,1554,0.87,Gujarat-Matar -115
5,Aayshabanu Aabidhusen Malek,Independent,464,3,467,0.26,Gujarat-Matar -115
6,Chauhan Mahipatsinh Kesarisinh,Independent,17552,122,17674,9.95,Gujarat-Matar -115
7,Rajeshbhai Dashrathbhai Raval,Independent,1043,2,1045,0.59,Gujarat-Matar -115
8,NOTA,None of the Above,2773,4,2777,1.56,Gujarat-Matar -115
1,DESAI PANKAJBHAI VINUBHAI (GOTIYO),Bharatiya Janata Party,103699,670,104369,63.04,Gujarat-Nadiad -116
2,DHRUVAL PATEL,Indian National Congress,50002,496,50498,30.5,Gujarat-Nadiad -116
3,MUZFFARBEG HARUNBEG MIRZA,Log Party,390,3,393,0.24,Gujarat-Nadiad -116
4,VANKAWALA IMRANBHAI BILALBHAI,Right to Recall Party,163,0,163,0.1,Gujarat-Nadiad -116
5,HARSHADKUMAR SURESHBHAI VAGHELA,Aam Aadmi Party,4450,196,4646,2.81,Gujarat-Nadiad -116
6,ANVARBHAI GULAMRASUL KASAI,Independent,128,0,128,0.08,Gujarat-Nadiad -116
7,MALHOTRA DIPAKKUMAR JONBHAI,Independent,220,6,226,0.14,Gujarat-Nadiad -116
8,RAFIKBHAI FARIDBHAI CHHIPA,Independent,149,3,152,0.09,Gujarat-Nadiad -116
9,VAHORA AIYUBBHAI HAJIBHAI,Independent,202,2,204,0.12,Gujarat-Nadiad -116
10,SAJIDHUSEN SABBIRMIYA MALEK,Independent,346,0,346,0.21,Gujarat-Nadiad -116
11,SIDDHARTH  JOSEPH MACWAN,Independent,762,9,771,0.47,Gujarat-Nadiad -116
12,NOTA,None of the Above,3649,23,3672,2.22,Gujarat-Nadiad -116
1,Arjunsinh Udesinh Chauhan,Bharatiya Janata Party,108185,356,108541,59.54,Gujarat-Mehmedabad -117
2,Juvansinh Gandabhai Chauhan,Indian National Congress,62666,271,62937,34.52,Gujarat-Mehmedabad -117
3,Pramodbhai Somabhai Chauhan,Aam Aadmi Party,4257,106,4363,2.39,Gujarat-Mehmedabad -117
4,Patel Bhavikkumar Vajendrakumar,Independent,1210,6,1216,0.67,Gujarat-Mehmedabad -117
5,Punambhai Mohanbhai Chauhan,Independent,473,2,475,0.26,Gujarat-Mehmedabad -117
6,Pravinsinh Ratansinh Chauhan,Independent,1232,1,1233,0.68,Gujarat-Mehmedabad -117
7,NOTA,None of the Above,3529,6,3535,1.94,Gujarat-Mehmedabad -117
1,INDRAJITSINH NATVARSINH PARMAR,Indian National Congress,65824,387,66211,37.75,Gujarat-Mahudha -118
2,SANJAYSINH VIJAYSINH MAHIDA,Bharatiya Janata Party,91453,447,91900,52.39,Gujarat-Mahudha -118
3,RAVJIBHAI SOMABHAI VAGHELA,Aam Aadmi Party,11960,145,12105,6.9,Gujarat-Mahudha -118
4,ARIFBHAI GULAMNABI VAHORA,Independent,382,2,384,0.22,Gujarat-Mahudha -118
5,PUJAMIYA FAKIRMIYA MALEK,Independent,334,0,334,0.19,Gujarat-Mahudha -118
6,VAJIDHUSEN ABBASMIYA MALEK,Independent,800,0,800,0.46,Gujarat-Mahudha -118
7,SHEKH IRSHADMAHAMMAD NAJIRMOHAMMAD,Independent,1145,2,1147,0.65,Gujarat-Mahudha -118
8,NOTA,None of the Above,2533,0,2533,1.44,Gujarat-Mahudha -118
1,Parmar Kantibhai Shabhaibhai,Indian National Congress,59185,244,59429,30.24,Gujarat-Thasra -119
2,Yogendrasinh Parmar (BAKABHAI),Bharatiya Janata Party,120885,463,121348,61.76,Gujarat-Thasra -119
3,Jiteshkumar Ghanshyambhai Sevak (Jitubhai Sevak),Garvi Gujarat Party,1175,2,1177,0.6,Gujarat-Thasra -119
4,Rathod Natvarsinh Punjabhai,Aam Aadmi Party,3143,70,3213,1.64,Gujarat-Thasra -119
5,Dipak I Sevak (Ram),Independent,290,0,290,0.15,Gujarat-Thasra -119
6,Majarali Amirali Kazi,Independent,345,1,346,0.18,Gujarat-Thasra -119
7,Maheshkumar Ramsinh Parmar,Independent,5649,6,5655,2.88,Gujarat-Thasra -119
8,Rafiq Ahmedkhan,Independent,2325,0,2325,1.18,Gujarat-Thasra -119
9,NOTA,None of the Above,2710,4,2714,1.38,Gujarat-Thasra -119
1,Kalabhai Raijibhai  Dabhi,Indian National Congress,79463,695,80158,38.62,Gujarat-Kapadvanj -120
2,Zala Rajeshkumar Maganbhai,Bharatiya Janata Party,111240,796,112036,53.97,Gujarat-Kapadvanj -120
3,Ajaykumar  Pravinsinh Solanki,Garvi Gujarat Party,2426,18,2444,1.18,Gujarat-Kapadvanj -120
4,Parmar Rahulkumar Hasmukhbhai,Praja Vijay Paksh,814,2,816,0.39,Gujarat-Kapadvanj -120
5,Manubhai Ramabhai Patel,Aam Aadmi Party,8644,257,8901,4.29,Gujarat-Kapadvanj -120
6,NOTA,None of the Above,3215,8,3223,1.55,Gujarat-Kapadvanj -120
1,Ajitsinh Parvatsinh Chauhan,Indian National Congress,40620,459,41079,22.54,Gujarat-Balasinor -121
2,Mansinh Kohyabhai Chauhan,Bharatiya Janata Party,91835,666,92501,50.76,Gujarat-Balasinor -121
3,Khant Ashvinbhai Ramanbhai (A.K.),Garvi Gujarat Party,3037,12,3049,1.67,Gujarat-Balasinor -121
4,Udesinh Rayjibhai Chauhan,Aam Aadmi Party,39009,560,39569,21.71,Gujarat-Balasinor -121
5,Magansinh Bhemsinh Parmar,Jan Sangh Party,633,3,636,0.35,Gujarat-Balasinor -121
6,Zala Kiritsinh Prabhatsinh,Independent,598,2,600,0.33,Gujarat-Balasinor -121
7,Zala Chandrasinh Fatesinh,Independent,657,1,658,0.36,Gujarat-Balasinor -121
8,Chavda Natvarsinh Fulsinh,Independent,1427,0,1427,0.78,Gujarat-Balasinor -121
9,NOTA,None of the Above,2713,11,2724,1.49,Gujarat-Balasinor -121
1,GULABSINH SOMSINH CHAUHAN,Indian National Congress,71326,761,72087,39.19,Gujarat-Lunawada -122
2,MAKWANA RAMESHBHAI SUNDARBHAI,Bahujan Samaj Party,1374,2,1376,0.75,Gujarat-Lunawada -122
3,SEVAK JIGNESHKUMAR AMBALAL,Bharatiya Janata Party,45071,396,45467,24.72,Gujarat-Lunawada -122
4,NAT PARVATIBEN PRABHATBHAI,Praja Vijay Paksh,1004,1,1005,0.55,Gujarat-Lunawada -122
5,NATVARSINH MOTISINH SOLANKI,Aam Aadmi Party,5654,263,5917,3.22,Gujarat-Lunawada -122
6,KHANT SHAKANBHAI MOTIBHAI,Independent,9548,32,9580,5.21,Gujarat-Lunawada -122
7,JAYPRAKASH PURUSHOTTAMBHAI PATEL (J.P.),Independent,42709,1040,43749,23.78,Gujarat-Lunawada -122
8,PUSHPA VIKRAMSINH MALIVAD (DAMOR),Independent,1484,7,1491,0.81,Gujarat-Lunawada -122
9,NOTA,None of the Above,3281,7,3288,1.79,Gujarat-Lunawada -122
1,Dr. Kuberbhai Mansukhbhai Dindor,Bharatiya Janata Party,49219,745,49964,34.99,Gujarat-Santrampur -123
2,Gendalbhai Motibhai Damor,Indian National Congress,34014,373,34387,24.08,Gujarat-Santrampur -123
3,Parvatbhai Akhamabhai Vagadiya,Aam Aadmi Party,23956,598,24554,17.19,Gujarat-Santrampur -123
4,Prabhubhai Jagjivan Ganasva,Gujarat Nav Nirman Sena,1044,5,1049,0.73,Gujarat-Santrampur -123
5,Ramanbhai Punjabhai Khant,Bhartiya Jan Parishad,1181,3,1184,0.83,Gujarat-Santrampur -123
6,Babubhai Hirabhai Damor,Independent,28302,329,28631,20.05,Gujarat-Santrampur -123
7,NOTA,None of the Above,3029,10,3039,2.13,Gujarat-Santrampur -123
1,Ahir(Bharvad) Jethabhai Ghelabhai,Bharatiya Janata Party,107082,693,107775,59.45,Gujarat-Shehra -124
2,Khatubhai Gulabbhai Pagi,Indian National Congress,59986,508,60494,33.37,Gujarat-Shehra -124
3,Takhatsinh Ravsinh Solanki,Aam Aadmi Party,6115,346,6461,3.56,Gujarat-Shehra -124
4,Sureshbhai Mithabhai Parmar,Bhartiya Jan Parishad,1827,8,1835,1.01,Gujarat-Shehra -124
5,NOTA,None of the Above,4701,7,4708,2.6,Gujarat-Shehra -124
1,KHANT SNEHLATTABEN GOVINDKUMAR,Indian National Congress,21952,232,22184,15.68,Gujarat-Morva Hadaf -125
2,SUTHAR NIMISHABEN MANHARSINH,Bharatiya Janata Party,81239,658,81897,57.88,Gujarat-Morva Hadaf -125
3,BHANABHAI MANSUKHBHAI DAMOR,Aam Aadmi Party,32286,734,33020,23.34,Gujarat-Morva Hadaf -125
4,MACHHAR CHANDRAKANTBHAI HIRABHAI,Praja Vijay Paksh,1804,7,1811,1.28,Gujarat-Morva Hadaf -125
5,NOTA,None of the Above,2569,5,2574,1.82,Gujarat-Morva Hadaf -125
1,RASHMITABEN DUSHYANTSINH CHAUHAN,Indian National Congress,60599,426,61025,32.76,Gujarat-Godhra -126
2,C.K.RAULJI,Bharatiya Janata Party,95561,662,96223,51.65,Gujarat-Godhra -126
3,RAJESHBHAI SOMABHAI PATEL,Aam Aadmi Party,11200,627,11827,6.35,Gujarat-Godhra -126
4,RATHOD NARVARSINH HATHISINH,Praja Vijay Paksh,330,0,330,0.18,Gujarat-Godhra -126
5,HASAN SHABBIR KACHABA,All India Majlis-E-Ittehadul Muslimeen,9462,46,9508,5.1,Gujarat-Godhra -126
6,KALANDAR MOHAMMEDHANIF AHMEDSAEED,Independent,218,1,219,0.12,Gujarat-Godhra -126
7,PATEL MAYURKUMAR JASHAVANTLAL,Independent,309,2,311,0.17,Gujarat-Godhra -126
8,BADAM MO.SAID YUSUF,Independent,312,4,316,0.17,Gujarat-Godhra -126
9,SAIYED SAFIKALI RASHIDALI,Independent,702,5,707,0.38,Gujarat-Godhra -126
10,HUSNAIN JAKKIUDDIN PRESSWALA,Independent,2289,0,2289,1.23,Gujarat-Godhra -126
11,NOTA,None of the Above,3547,1,3548,1.9,Gujarat-Godhra -126
1,PRABHATSINH PRATAPSINH CHAUHAN,Indian National Congress,25859,148,26007,13.77,Gujarat-Kalol -127
2,FATESINH VAKHATSINH CHAUHAN,Bharatiya Janata Party,140983,703,141686,75.03,Gujarat-Kalol -127
3,VAGHELA SATISHKUMAR RAMESHBHAI,Bahujan Samaj Party,1505,2,1507,0.8,Gujarat-Kalol -127
4,CHAUHAN VIJAYSINH MAGANSINH,Garvi Gujarat Party,851,7,858,0.45,Gujarat-Kalol -127
5,JAYESHKUMAR SHANTUBHAI RATHOD,Pachchasi Parivartan Samaj Party,345,3,348,0.18,Gujarat-Kalol -127
6,JADAV MAHENDRASINH RAMSINH,Lok Janshakti Party(Ram Vilas),408,3,411,0.22,Gujarat-Kalol -127
7,THAKOR RAMENDRASINH JASHVANTSINH,Praja Vijay Paksh,409,3,412,0.22,Gujarat-Kalol -127
8,DINESHBHAI KANUBHAI BARIA,Aam Aadmi Party,9192,201,9393,4.97,Gujarat-Kalol -127
9,JADAV DEVENDRASINH VAGHSINH,Independent,870,6,876,0.46,Gujarat-Kalol -127
10,PUNAMCHAND MADABHAI HARIJAN,Independent,873,3,876,0.46,Gujarat-Kalol -127
11,VANKAR DAHYABHAI JESINGBHAI,Independent,2475,2,2477,1.31,Gujarat-Kalol -127
12,NOTA,None of the Above,3981,11,3992,2.11,Gujarat-Kalol -127
1,ANISHBHAI GORDHANBHAI BARIA,Indian National Congress,6919,45,6964,3.5,Gujarat-Halol -128
2,JAYDRATHSINHJI PARMAR,Bharatiya Janata Party,100002,751,100753,50.7,Gujarat-Halol -128
3,NAYAK SOMABHAI MEGHABHAI,Bahujan Samaj Party,1930,3,1933,0.97,Gujarat-Halol -128
4,BHARATKUMAR RATHAVA,Aam Aadmi Party,21468,320,21788,10.96,Gujarat-Halol -128
5,RATHAVA SEVAJIBHAI BHILABHAI,Praja Vijay Paksh,791,5,796,0.4,Gujarat-Halol -128
6,JADAV MUKTIBEN RAJENDRASINH,Independent,1237,18,1255,0.63,Gujarat-Halol -128
7,PARMAR REKHABEN RAJENDRASINH,Independent,980,5,985,0.5,Gujarat-Halol -128
8,RAMCHANDRA BARIA,Independent,57770,278,58048,29.21,Gujarat-Halol -128
9,SOLANKI ISHVARBHAI,Independent,2720,7,2727,1.37,Gujarat-Halol -128
10,NOTA,None of the Above,3454,6,3460,1.74,Gujarat-Halol -128
1,KATARA RAMESHBHAI BHURABHAI,Bharatiya Janata Party,59231,350,59581,42.78,Gujarat-Fatepura -129
2,KANUBHAI KUBERBHAI KATARA,Communist Party of India  (Marxist),1710,0,1710,1.23,Gujarat-Fatepura -129
3,MACHHAR RAGHUBHAI DITABHAI,Indian National Congress,29198,281,29479,21.17,Gujarat-Fatepura -129
4,ALKESHBHAI FULSINGBHAI KATARA,Bhartiya Tribal Party,1535,11,1546,1.11,Gujarat-Fatepura -129
5,KISHORI RAKESHBHAI AMBALAL,Gujarat Nav Nirman Sena,1152,8,1160,0.83,Gujarat-Fatepura -129
6,GOVINDBHAI DALABHAI PARMAR,Aam Aadmi Party,39140,910,40050,28.76,Gujarat-Fatepura -129
7,MACHHAR VIRABHAI MAKANBHAI,Bhartiya Jan Parishad,1414,0,1414,1.02,Gujarat-Fatepura -129
8,NOTA,None of the Above,4325,2,4327,3.11,Gujarat-Fatepura -129
1,MAHESHBHAI SOMJIBHAI BHURIYA,Bharatiya Janata Party,82429,316,82745,51.41,Gujarat-Jhalod -130
2,MITESHBHAI KALABHAI GARASIYA,Indian National Congress,21863,133,21996,13.67,Gujarat-Jhalod -130
3,ANILBHAI SOMABHAI GARASIYA,Aam Aadmi Party,46897,626,47523,29.53,Gujarat-Jhalod -130
4,MANSUKHBHAI RATANBHAI KATARA,Bhartiya Tribal Party,1525,0,1525,0.95,Gujarat-Jhalod -130
5,MOHANBHAI PARSINGBHAI SANGADA,Independent,1209,1,1210,0.75,Gujarat-Jhalod -130
6,HARICHANDRA SHASHIKANTBHAI MAHIDA,Independent,1308,0,1308,0.81,Gujarat-Jhalod -130
7,NOTA,None of the Above,4642,4,4646,2.89,Gujarat-Jhalod -130
1,Gondiya Rameshkumar Badiyabhai,Indian National Congress,8059,34,8093,5.38,Gujarat-Limkheda -131
2,Nisarata Nileshbhai Lalsingbhai,Communist Party of India  (Marxist),2027,0,2027,1.35,Gujarat-Limkheda -131
3,Bhabhor Shaileshbhai Sumanbhai,Bharatiya Janata Party,69067,350,69417,46.13,Gujarat-Limkheda -131
4,Baria Nareshbhai Punabhai,Aam Aadmi Party,65039,715,65754,43.69,Gujarat-Limkheda -131
5,Laxmansinh Lalsingbhai Vadkiya,Independent,2839,1,2840,1.89,Gujarat-Limkheda -131
6,NOTA,None of the Above,2355,2,2357,1.57,Gujarat-Limkheda -131
1,Kanaiyalal Bachubhai Kishori,Bharatiya Janata Party,72198,462,72660,43.54,Gujarat-Dahod -132
2,Harshadbhai Valchandbhai Ninama,Indian National Congress,43130,180,43310,25.95,Gujarat-Dahod -132
3,Mandod Vinodkumar Pratapsinh (Khannasir),Bahujan Samaj Party,1442,4,1446,0.87,Gujarat-Dahod -132
4,Meda Devendrabhai Laxmanbhai (Devabhai),Bhartiya Tribal Party,1608,6,1614,0.97,Gujarat-Dahod -132
5,Pro. Dr. Dineshbhai Bhurabhai Muniya,Aam Aadmi Party,33486,524,34010,20.38,Gujarat-Dahod -132
6,Kishanbhai Meghjibhai Palas,Independent,10783,25,10808,6.48,Gujarat-Dahod -132
7,NOTA,None of the Above,3036,10,3046,1.83,Gujarat-Dahod -132
1,CHANDRIKABEN CHHAGANBHAI BARIYA,Indian National Congress,34391,211,34602,23.59,Gujarat-Garbada -133
2,BHABHOR DHULABHAI DITABHAI,Bahujan Samaj Party,2214,8,2222,1.51,Gujarat-Garbada -133
3,BHABHOR MAHENDRABHAI RAMESHBHAI,Bharatiya Janata Party,62276,151,62427,42.55,Gujarat-Garbada -133
4,JAGDISHBHAI MANILAL MEDA,Bharatiya National Janta Dal,2129,1,2130,1.45,Gujarat-Garbada -133
5,BHABHOR RAMASUBHAI JOGADABHAI,Bhartiya Tribal Party,1361,1,1362,0.93,Gujarat-Garbada -133
6,SHAILESHBHAI KANUBHAI BHABHOR,Aam Aadmi Party,33091,504,33595,22.9,Gujarat-Garbada -133
7,BAMANYA KETANKUMAR KASNABHAI,Independent,6070,149,6219,4.24,Gujarat-Garbada -133
8,NOTA,None of the Above,4149,3,4152,2.83,Gujarat-Garbada -133
1,Khabad Bachubhai Maganbhai,Bharatiya Janata Party,113038,489,113527,58.27,Gujarat-Devgadhbaria -134
2,Chauhan Samatsinh Mansukhbhai,Praja Vijay Paksh,5125,56,5181,2.66,Gujarat-Devgadhbaria -134
3,Vakhala Bharatsinh Pratapbhai,Aam Aadmi Party,68704,622,69326,35.58,Gujarat-Devgadhbaria -134
4,Patel Bhimsing Maganbhai,Independent,1983,1,1984,1.02,Gujarat-Devgadhbaria -134
5,NOTA,None of the Above,4818,3,4821,2.47,Gujarat-Devgadhbaria -134
1,ANILBHAI LALLUBHAI PARMAR,Bahujan Samaj Party,2089,1,2090,1.2,Gujarat-Savli -135
2,INAMDAR KETANBHAI MAHENDRABHAI,Bharatiya Janata Party,101717,287,102004,58.4,Gujarat-Savli -135
3,KULDIPSINH UDESINH RAULJI(VAKIL),Indian National Congress,64826,252,65078,37.26,Gujarat-Savli -135
4,VIJAYKUMAR NARVATSINH CHAVDA,Aam Aadmi Party,2015,17,2032,1.16,Gujarat-Savli -135
5,PARMAR RAJESHKUMAR BACHUBHAI,Independent,888,0,888,0.51,Gujarat-Savli -135
6,VIJAYSINH DALPATSINH MAHIDA,Independent,967,0,967,0.55,Gujarat-Savli -135
7,NOTA,None of the Above,1594,0,1594,0.91,Gujarat-Savli -135
1,ASHVINBHAI NATVARBHAI PATEL (KAKA),Bharatiya Janata Party,63781,118,63899,34.98,Gujarat-Vaghodia -136
2,MANSUKHBHAI HARJIBHAI CHAUHAN,Bahujan Samaj Party,1082,2,1084,0.59,Gujarat-Vaghodia -136
3,SATYAJITSINH DULEEPSINH GAEKWAD,Indian National Congress,18827,43,18870,10.33,Gujarat-Vaghodia -136
4,GAUTAMKUMAR SAMPATBHAI SOLANKI (RAJPUT),Aam Aadmi Party,2960,35,2995,1.64,Gujarat-Vaghodia -136
5,NIMESHBHAI ARUNKUMAR BENDRE,Log Party,639,0,639,0.35,Gujarat-Vaghodia -136
6,DHARMENDRASINH RANUBHA VAGHELA (BAPU),Independent,77667,238,77905,42.65,Gujarat-Vaghodia -136
7,MADHUBHAI BABUBHAI SHRIVASTAV,Independent,14586,59,14645,8.02,Gujarat-Vaghodia -136
8,NOTA,None of the Above,2619,3,2622,1.44,Gujarat-Vaghodia -136
1,RAJENDRASINH MOHANSINH RATHVA,Bharatiya Janata Party,74483,646,75129,43.23,Gujarat-Chhota Udaipur -137
2,RATHWA SANGRAMSINH NARANBHAI,Indian National Congress,45149,530,45679,26.28,Gujarat-Chhota Udaipur -137
3,PROF. ARJUN  RATHVA,Aam Aadmi Party,42708,1172,43880,25.25,Gujarat-Chhota Udaipur -137
4,RATHVA GIRMAABHAI MATHURBHAI,Bhartiya Tribal Party,2012,1,2013,1.16,Gujarat-Chhota Udaipur -137
5,RATHVA DEVLABHAI BHULABHAI,Praja Vijay Paksh,2004,2,2006,1.15,Gujarat-Chhota Udaipur -137
6,NOTA,None of the Above,5090,3,5093,2.93,Gujarat-Chhota Udaipur -137
1,RATHWA JAYANTIBHAI SAVJIBHAI,Bharatiya Janata Party,85545,496,86041,47.53,Gujarat-Jetpur -138
2,SUKHRAMBHAI HARIYABHAI RATHWA,Indian National Congress,33423,249,33672,18.6,Gujarat-Jetpur -138
3,RATHWA NAMALABHAI (NARENDRABHAI) GURJIBHAI,Bhartiya Tribal Party,4306,20,4326,2.39,Gujarat-Jetpur -138
4,RATHWA NEVSINGBHAI CHHAGANBHAI,Pachchasi Parivartan Samaj Party,1165,0,1165,0.64,Gujarat-Jetpur -138
5,RATHWA RADHIKABEN AMARSINGHBHAI,Aam Aadmi Party,47439,823,48262,26.66,Gujarat-Jetpur -138
6,VARSANBHAI FULJIBHAI RATHWA,Independent,2941,3,2944,1.63,Gujarat-Jetpur -138
7,NOTA,None of the Above,4593,5,4598,2.54,Gujarat-Jetpur -138
1,Abhesinh Motibhai Tadvi,Bharatiya Janata Party,99114,273,99387,51.03,Gujarat-Sankheda -139
2,Dhirubhai Chunilal Bhil,Indian National Congress,68478,235,68713,35.28,Gujarat-Sankheda -139
3,Tadvi Ranjanbhai Kanchanbhai,Aam Aadmi Party,18159,185,18344,9.42,Gujarat-Sankheda -139
4,Rathva Furkanbhai Baljibhai,Bhartiya Tribal Party,1099,1,1100,0.56,Gujarat-Sankheda -139
5,Rathva Hirubhai Darjibhai,Pachchasi Parivartan Samaj Party,1039,0,1039,0.53,Gujarat-Sankheda -139
6,Satishkumar Chandubhai Tadvi,Independent,2015,3,2018,1.04,Gujarat-Sankheda -139
7,NOTA,None of the Above,4136,7,4143,2.13,Gujarat-Sankheda -139
1,Balkrishnabhai Naranbhai Patel (Dholar),Indian National Congress,68029,341,68370,40.02,Gujarat-Dabhoi -140
2,Shaileshbhai Kanaiyalal Mehta (Shailesh Sotta),Bharatiya Janata Party,88353,493,88846,52.01,Gujarat-Dabhoi -140
3,Shaukatali Abdal,Bahujan Samaj Party,775,1,776,0.45,Gujarat-Dabhoi -140
4,Ajitsinh Parsottamdas Thakor,Aam Aadmi Party,7760,151,7911,4.63,Gujarat-Dabhoi -140
5,Patel Jayeshbhai Chimanbhai,Bhartiya Tribal Party,317,0,317,0.19,Gujarat-Dabhoi -140
6,Pruthvisinh Ranvirsinh Gohil (Bapu),Rashtriya Samaj Paksha,324,6,330,0.19,Gujarat-Dabhoi -140
7,Yusufbhai Gulamhusen Fatiya (Patrkar),Independent,318,1,319,0.19,Gujarat-Dabhoi -140
8,Rohit Navinbhai Krushnkant,Independent,391,0,391,0.23,Gujarat-Dabhoi -140
9,Hemantkumar Arvindbhai Parmar,Independent,903,3,906,0.53,Gujarat-Dabhoi -140
10,NOTA,None of the Above,2649,6,2655,1.55,Gujarat-Dabhoi -140
1,GUNVANTRAY PARMAR,Indian National Congress,31907,201,32108,17.34,Gujarat-Vadodara City -141
2,DILIPSINH VALJIBHAI KATARIA,Bahujan Samaj Party,795,1,796,0.43,Gujarat-Vadodara City -141
3,MANISHA VAKIL,Bharatiya Janata Party,130112,593,130705,70.57,Gujarat-Vadodara City -141
4,NAYNA KANJIBHAI PARMAR,Rashtriya Samaj Paksha,807,1,808,0.44,Gujarat-Vadodara City -141
5,VASAIKAR NILESH JAGANNATHBHAI,Satyawadi Rakshak Party,382,3,385,0.21,Gujarat-Vadodara City -141
6,SOLANKI JIGARBHAI BHANUPRASAD,Aam Aadmi Party,15619,283,15902,8.59,Gujarat-Vadodara City -141
7,RAJWADI ANKITBHAI,Independent,485,0,485,0.26,Gujarat-Vadodara City -141
8,NOTA,None of the Above,3989,33,4022,2.17,Gujarat-Vadodara City -141
1,AMI RAVAT,Indian National Congress,37822,231,38053,21.34,Gujarat-Sayajigunj -142
2,KEYUR NARAYANDAS ROKADIA,Bharatiya Janata Party,121528,538,122066,68.45,Gujarat-Sayajigunj -142
3,NEHA PARMAR,Bahujan Samaj Party,1244,7,1251,0.7,Gujarat-Sayajigunj -142
4,SWEJAL BHARATBHAI VYAS,Aam Aadmi Party,12841,239,13080,7.33,Gujarat-Sayajigunj -142
5,DHAVAL ANIL CHAVAN,Independent,452,2,454,0.25,Gujarat-Sayajigunj -142
6,NOTA,None of the Above,3416,16,3432,1.92,Gujarat-Sayajigunj -142
1,Rutvij Dilipbhai Joshi,Indian National Congress,35369,190,35559,21.58,Gujarat-Akota -143
2,Chaitanya  Makarandbhai  Desai,Bharatiya Janata Party,112810,502,113312,68.76,Gujarat-Akota -143
3,Narendrabhai  Lalubhai Parmar,Akhil Bharat Hindu Mahasabha,426,3,429,0.26,Gujarat-Akota -143
4,Bharti Parmar,SOCIALIST UNITY CENTRE OF INDIA (COMMUNIST),341,2,343,0.21,Gujarat-Akota -143
5,Mukesh Shivprasad Nayak,Rashtriya Samaj Paksha,324,2,326,0.2,Gujarat-Akota -143
6,Rajeshbhai  Bhikhabhai Mali,Gujarat Nav Nirman Sena,281,2,283,0.17,Gujarat-Akota -143
7,Shashank  Rajesh Khare,Aam Aadmi Party,9744,274,10018,6.08,Gujarat-Akota -143
8,Jatin Shah,Independent,915,6,921,0.56,Gujarat-Akota -143
9,Dineshbhai  Vyas,Independent,225,0,225,0.14,Gujarat-Akota -143
10,Deepak Harishchandra  Palkar,Independent,248,0,248,0.15,Gujarat-Akota -143
11,Dr. Rahul Vasudevbhai Vyas,Independent,291,0,291,0.18,Gujarat-Akota -143
12,NOTA,None of the Above,2822,17,2839,1.72,Gujarat-Akota -143
1,PATEL SANJAYBHAI ISHWARBHAI SP(SANJAY PATEL),Indian National Congress,38076,190,38266,22.12,Gujarat-Raopura -144
2,BALKRUSHNA KHANDERAO SHUKLA (BALU SHUKLA),Bharatiya Janata Party,118711,590,119301,68.96,Gujarat-Raopura -144
3,ROHIT MAHESHKUMAR GOVINDBHAI,Bahujan Samaj Party,691,5,696,0.4,Gujarat-Raopura -144
4,HIREN RAMESHRAORAJE SHIRKE,Aam Aadmi Party,10140,297,10437,6.03,Gujarat-Raopura -144
5,HUSENBHAI AEHMADBHAI MULTANI,Rashtriya Samaj Paksha,263,0,263,0.15,Gujarat-Raopura -144
6,IMRAN GULAMMAIYUDEEN MANSURI,Independent,403,0,403,0.23,Gujarat-Raopura -144
7,HARDIK BIPINBHAI DOSHI,Independent,449,1,450,0.26,Gujarat-Raopura -144
8,NOTA,None of the Above,3157,26,3183,1.84,Gujarat-Raopura -144
1,Dr.Tashveen Singh,Indian National Congress,19208,171,19379,12.24,Gujarat-Manjalpur -145
2,Bharat Rohit (Baba),Bahujan Samaj Party,2223,17,2240,1.41,Gujarat-Manjalpur -145
3,Yogeshbhai Narandas Patel,Bharatiya Janata Party,119459,674,120133,75.85,Gujarat-Manjalpur -145
4,Chetan Arunbhai Pandit,Akhil Bharat Hindu Mahasabha,843,2,845,0.53,Gujarat-Manjalpur -145
5,Chauhan Vinay Subhash (Fouji),Aam Aadmi Party,10410,611,11021,6.96,Gujarat-Manjalpur -145
6,Tribhuvan Bhila Patil,Bhartiya Jan Parishad,409,12,421,0.27,Gujarat-Manjalpur -145
7,Prakashbhai Somabhai Patel,Rashtriya Samaj Paksha,635,0,635,0.4,Gujarat-Manjalpur -145
8,Piyush Patel,Independent,464,3,467,0.29,Gujarat-Manjalpur -145
9,NOTA,None of the Above,3210,24,3234,2.04,Gujarat-Manjalpur -145
1,CHAITANYASINH PRATAPSINH ZALA,Bharatiya Janata Party,66052,174,66226,36.09,Gujarat-Padra -146
2,JASHPALSINH MAHENDRASINH PADHIYAR,Indian National Congress,59826,222,60048,32.72,Gujarat-Padra -146
3,MAKWANA SAVITABEN SATISHKUMAR,Bahujan Samaj Party,1171,1,1172,0.64,Gujarat-Padra -146
4,SANDIPSINH VIKRAMSINH RAJ,Aam Aadmi Party,1970,29,1999,1.09,Gujarat-Padra -146
5,DINESHBHAI BALUBHAI PATEL (DINUMAMA),Independent,50906,203,51109,27.85,Gujarat-Padra -146
6,LAXMANBHAI SHANABHAI SOLANKI,Independent,895,1,896,0.49,Gujarat-Padra -146
7,NOTA,None of the Above,2067,4,2071,1.13,Gujarat-Padra -146
1,AKSHAYKUMAR ISHVARBHAI PATEL,Bharatiya Janata Party,83378,370,83748,54.68,Gujarat-Karjan -147
2,PRITESHKUMAR JANAKBHAI PATEL (PINTU PATEL VEMARDI),Indian National Congress,57266,176,57442,37.5,Gujarat-Karjan -147
3,YUSUF VALI HASANALI,Bahujan Samaj Party,805,1,806,0.53,Gujarat-Karjan -147
4,GHANSHAM MELSANGBHAI VASAVA,Bhartiya Tribal Party,1491,17,1508,0.98,Gujarat-Karjan -147
5,PARESH PATEL(VAKIL),Aam Aadmi Party,6475,112,6587,4.3,Gujarat-Karjan -147
6,RAMANBHAI CHIMANBHAI VASAVA,Independent,773,2,775,0.51,Gujarat-Karjan -147
7,NOTA,None of the Above,2289,4,2293,1.5,Gujarat-Karjan -147
1,Dr. DARSHNA CHANDUBHAI DESHMUKH(VASAVA),Bharatiya Janata Party,70062,481,70543,39.74,Gujarat-Nandod -148
2,HARESHBHAI  JAYANTIBHAI VASAVA,Indian National Congress,41724,617,42341,23.85,Gujarat-Nandod -148
3,Dr. PRAFULBHAI DEVJIBHAI VASAVA,Aam Aadmi Party,23467,996,24463,13.78,Gujarat-Nandod -148
4,MAHESHBHAI SARADBHAI VASAVA (MANABHAI),Bhartiya Tribal Party,1697,7,1704,0.96,Gujarat-Nandod -148
5,HARSHADBHAI CHUNILAL VASAVA,Independent,34835,527,35362,19.92,Gujarat-Nandod -148
6,NOTA,None of the Above,3091,13,3104,1.75,Gujarat-Nandod -148
1,Jermaben Suklal Vasava,Indian National Congress,12552,35,12587,6.8,Gujarat-Dediapada -149
2,Hiteshkumar Devjibhai Vasava,Bharatiya Janata Party,62999,152,63151,34.11,Gujarat-Dediapada -149
3,Chaitarbhai Damjibhai Vasava,Aam Aadmi Party,102402,1031,103433,55.87,Gujarat-Dediapada -149
4,Bahadursing Devjibhai Vasava,Bhartiya Tribal Party,2985,6,2991,1.62,Gujarat-Dediapada -149
5,NOTA,None of the Above,2972,2,2974,1.61,Gujarat-Dediapada -149
1,DEVKISHORDASJI BHAKTISVARUPDASJI SWAMI,Bharatiya Janata Party,90907,626,91533,55.74,Gujarat-Jambusar -150
2,SANJAYBHAI JESANGBHAI SOLANKI,Indian National Congress,63928,225,64153,39.07,Gujarat-Jambusar -150
3,JAMBU PRAMODBHAI BHAGUBHAI,Bahujan Republican  Socialist Party,820,7,827,0.5,Gujarat-Jambusar -150
4,MANILAL BHOGILAL PANDYA,Bhartiya Tribal Party,517,1,518,0.32,Gujarat-Jambusar -150
5,SAJIDKHAN HUSENMAHAMMADKHAN REHAN,Aam Aadmi Party,3387,31,3418,2.08,Gujarat-Jambusar -150
6,ISMAIL AHMAD PATEL,Independent,820,1,821,0.5,Gujarat-Jambusar -150
7,SURESHBHAI DAHYABHAI PARMAR,Independent,662,2,664,0.4,Gujarat-Jambusar -150
8,NOTA,None of the Above,2269,4,2273,1.38,Gujarat-Jambusar -150
1,ARUNSINH AJITSINH RANA,Bharatiya Janata Party,82790,246,83036,51.84,Gujarat-Vagra -151
2,SULEMAN PATEL,Indian National Congress,69380,204,69584,43.44,Gujarat-Vagra -151
3,ILYAS YUSUF MANSURI,Bhartiya Tribal Party,532,1,533,0.33,Gujarat-Vagra -151
4,JAYENDRASINH LAXMANSINH RAJ,Aam Aadmi Party,1899,25,1924,1.2,Gujarat-Vagra -151
5,IKBAL MOHMEDBHAI BHOMLI,Independent,210,0,210,0.13,Gujarat-Vagra -151
6,KAMLESHBHAI S. MADHIWALA,Independent,1337,3,1340,0.84,Gujarat-Vagra -151
7,GOHIL  CHETANBHAI CHHAGANBHAI,Independent,182,3,185,0.12,Gujarat-Vagra -151
8,TALATI MUSTAK ISMAIL,Independent,256,1,257,0.16,Gujarat-Vagra -151
9,MUBARAK ISMAIL DASHU,Independent,688,2,690,0.43,Gujarat-Vagra -151
10,NOTA,None of the Above,2415,6,2421,1.51,Gujarat-Vagra -151
1,FATESINGBHAI CHIMANBHAI VASAVA,Indian National Congress,15128,91,15219,7.71,Gujarat-Jhagadia -152
2,RITESHKUMAR RAMANBHAI VASAVA (KALABHAI),Bharatiya Janata Party,89552,381,89933,45.55,Gujarat-Jhagadia -152
3,BHAGAT URMILABEN MUKESHBHAI,Aam Aadmi Party,19197,525,19722,9.99,Gujarat-Jhagadia -152
4,CHHOTUBHAI AMARSINH VASAVA,Independent,66185,248,66433,33.64,Gujarat-Jhagadia -152
5,VASAVA RANJITSINH GANPATSINH,Independent,3122,15,3137,1.59,Gujarat-Jhagadia -152
6,NOTA,None of the Above,3004,8,3012,1.53,Gujarat-Jhagadia -152
1,JAYKANTBHAI BAHECHARBHAI PATEL,Indian National Congress,44087,95,44182,25.71,Gujarat-Bharuch -153
2,RAMESHBHAI NARANDAS MISTRY,Bharatiya Janata Party,108181,474,108655,63.24,Gujarat-Bharuch -153
3,MANHARBHAI MAGANBHAI PARMAR,Aam Aadmi Party,14309,205,14514,8.45,Gujarat-Bharuch -153
4,MANSURI SAHILHUSHEN ISMAILBHAI,Independent,315,0,315,0.18,Gujarat-Bharuch -153
5,MIRZA ABIDBEG YASINBEG,Independent,213,0,213,0.12,Gujarat-Bharuch -153
6,VASAVA BHAGATSINH JESINGBHAI,Independent,606,5,611,0.36,Gujarat-Bharuch -153
7,VASAVA SURESHBHAI GORDHANDAS,Independent,606,1,607,0.35,Gujarat-Bharuch -153
8,NOTA,None of the Above,2698,24,2722,1.58,Gujarat-Bharuch -153
1,Ishwarsinh Thakorbhai Patel,Bharatiya Janata Party,96012,393,96405,60,Gujarat-Ankleshwar -154
2,Vijaysinh Thakorbhai Patel (Vallabhdas),Indian National Congress,55684,280,55964,34.83,Gujarat-Ankleshwar -154
3,Ankurkumar Laxmanbhai  Patel,Aam Aadmi Party,5277,79,5356,3.33,Gujarat-Ankleshwar -154
4,Jitendrasingh Rajawat,Praja Vijay Paksh,633,3,636,0.4,Gujarat-Ankleshwar -154
5,NOTA,None of the Above,2319,8,2327,1.45,Gujarat-Ankleshwar -154
1,DARSHANKUMAR AMRUTLAL NAYAK,Indian National Congress,57103,185,57288,19.4,Gujarat-Olpad -155
2,DIPAKBHAI PRAVINBHAI RATHOD,Communist Party of India  (Marxist),1015,2,1017,0.34,Gujarat-Olpad -155
3,BHALIYA KHIMJIBHAI HAKABHAI,Bahujan Samaj Party,1468,1,1469,0.5,Gujarat-Olpad -155
4,MUKESHBHAI ZINABHAI PATEL,Bharatiya Janata Party,172055,369,172424,58.39,Gujarat-Olpad -155
5,DHAMELIYA DINESHBHAI CHHAGANBHAI,Real Democracy Party,1375,2,1377,0.47,Gujarat-Olpad -155
6,DHARMIKBHAI NANUBHAI MALAVIYA,Aam Aadmi Party,52277,173,52450,17.76,Gujarat-Olpad -155
7,VIJAYBHAI RAMESHBHAI VASAVA,Bhartiya Tribal Party,2264,3,2267,0.77,Gujarat-Olpad -155
8,KHALIFA ABDULRAZAK AZIZ,Independent,271,0,271,0.09,Gujarat-Olpad -155
9,JIGNESHKUMAR MANJIBHAI DHAMELIYA,Independent,896,2,898,0.3,Gujarat-Olpad -155
10,DHOLARIYA VIRAL GOVINDBHAI,Independent,243,0,243,0.08,Gujarat-Olpad -155
11,NATVARBHAI DAHYABHAI MAHYAVANSHI,Independent,260,2,262,0.09,Gujarat-Olpad -155
12,PATEL SARFARAJ ABDULLA,Independent,415,0,415,0.14,Gujarat-Olpad -155
13,MALEK ASIFBHAI YUSUFBHAI,Independent,863,0,863,0.29,Gujarat-Olpad -155
14,SHEHNAZBIBI KHALIDBHAI SHEKH,Independent,355,0,355,0.12,Gujarat-Olpad -155
15,SAJID MEHMUD KOLA,Independent,556,0,556,0.19,Gujarat-Olpad -155
16,NOTA,None of the Above,3110,13,3123,1.06,Gujarat-Olpad -155
1,GANPATSINH VESTABHAI VASAVA,Bharatiya Janata Party,93327,342,93669,55.69,Gujarat-Mangrol -156
2,CHAUDHARI ANILBHAI SUMANBHAI,Indian National Congress,26633,85,26718,15.89,Gujarat-Mangrol -156
3,SAHDEV VASAVA (ADVOCATE),Bahujan Samaj Party,1260,1,1261,0.75,Gujarat-Mangrol -156
4,VASAVA SUBHASHBHAI KANJIBHAI,Bhartiya Tribal Party,1180,2,1182,0.7,Gujarat-Mangrol -156
5,SNEHALKUMAR RAMSING VASAVA,Aam Aadmi Party,41708,538,42246,25.12,Gujarat-Mangrol -156
6,NOTA,None of the Above,3103,8,3111,1.85,Gujarat-Mangrol -156
1,ASHOKBHAI CHHOTUBHAI CHAUDHARY,Bahujan Samaj Party,2290,2,2292,1.21,Gujarat-Mandvi -157
2,ANANDBHAI MOHANBHAI CHAUDHARI,Indian National Congress,56074,319,56393,29.74,Gujarat-Mandvi -157
3,KUNVARJIBHAI NARSINHBHAI HALPATI,Bharatiya Janata Party,74202,300,74502,39.29,Gujarat-Mandvi -157
4,BACHUBHAI GUMANBHAI CHAUDHARI,Bhartiya Tribal Party,1649,2,1651,0.87,Gujarat-Mandvi -157
5,SAYNABEN RUSTAMBHAI GAMIT,Aam Aadmi Party,48301,807,49108,25.9,Gujarat-Mandvi -157
6,CHAUDHARI PRADIPBHAI THAGABHAI,Independent,1720,0,1720,0.91,Gujarat-Mandvi -157
7,SURESHKUMAR JIVANBHAI GAMIT,Independent,1034,0,1034,0.55,Gujarat-Mandvi -157
8,NOTA,None of the Above,2894,8,2902,1.53,Gujarat-Mandvi -157
1,ARUNBHAI DHANJIBHAI SAKARIYA,Bahujan Samaj Party,1096,1,1097,0.33,Gujarat-Kamrej -158
2,NILESH KUMBHANI,Indian National Congress,27424,87,27511,8.31,Gujarat-Kamrej -158
3,PRAFUL PANSHERIYA,Bharatiya Janata Party,185204,381,185585,56.07,Gujarat-Kamrej -158
4,KHUSHWAH SUMANBEN RAVEEBHAI,Sardar Vallabhbhai Patel Party,901,0,901,0.27,Gujarat-Kamrej -158
5,DR. DINESHBHAI CHHAGANBHAI DHAMELIYA,Real Democracy Party,729,2,731,0.22,Gujarat-Kamrej -158
6,RAM DHADUK,Aam Aadmi Party,110501,387,110888,33.5,Gujarat-Kamrej -158
7,HEMENDRASINH RATHOD,Bhartiya Tribal Party,1387,5,1392,0.42,Gujarat-Kamrej -158
8,VIRADIYA PIYUSH HASMUKHBHAI,Independent,575,0,575,0.17,Gujarat-Kamrej -158
9,NOTA,None of the Above,2278,13,2291,0.69,Gujarat-Kamrej -158
1,ABDULSAMAD  ABDULMAJID MUNSHI,Bahujan Samaj Party,544,0,544,0.39,Gujarat-Surat East -159
2,ARVIND SHANTILAL RANA,Bharatiya Janata Party,73014,128,73142,52.45,Gujarat-Surat East -159
3,ASLAM FIROZBHAI CYCLEWALA,Indian National Congress,59072,53,59125,42.4,Gujarat-Surat East -159
4,KARIMKHAN RAHIMKHAN PATHAN,Bharatiya Bahujan Congress,604,0,604,0.43,Gujarat-Surat East -159
5,MANSUR AHMAD CHASHMAWALA,Samajwadi Party,1015,0,1015,0.73,Gujarat-Surat East -159
6,WASIM IKBALBHAI KHOKAR (KURESHI),All India Majlis-E-Ittehadul Muslimeen,1671,0,1671,1.2,Gujarat-Surat East -159
7,IBRAHIM YAKUB NAGORI,Independent,106,0,106,0.08,Gujarat-Surat East -159
8,KHER PARESH ANANDBHAI,Independent,667,1,668,0.48,Gujarat-Surat East -159
9,NURUBHAI SHAKURBHAI SHAIKH,Independent,59,0,59,0.04,Gujarat-Surat East -159
10,PATEL MINHAJ YUNUSBHAI,Independent,121,1,122,0.09,Gujarat-Surat East -159
11,PATHAN RIYAZKHAN ABDULKHAN,Independent,67,1,68,0.05,Gujarat-Surat East -159
12,MOHAMAD FAIZ MOHAMAD FARUQ MULLA,Independent,155,0,155,0.11,Gujarat-Surat East -159
13,SHAHABUDIN JAINUDIN MALBARI,Independent,476,0,476,0.34,Gujarat-Surat East -159
14,SAMIR FAKRUDDIN SHAIKH,Independent,211,0,211,0.15,Gujarat-Surat East -159
15,NOTA,None of the Above,1482,12,1494,1.07,Gujarat-Surat East -159
1,ACHCHHA SAEEDBHAI YUSUFBHAI,Bahujan Samaj Party,342,0,342,0.35,Gujarat-Surat North -160
2,ASHOK PATEL (ADHEVADA),Indian National Congress,14846,8,14854,15.37,Gujarat-Surat North -160
3,KANTIBHAI HIMMATBHAI BALAR,Bharatiya Janata Party,57048,69,57117,59.1,Gujarat-Surat North -160
4,ANISH AHMAD MORISWALA,Log Party,231,1,232,0.24,Gujarat-Surat North -160
5,MAHENDRA NAVADIYA,Aam Aadmi Party,22786,38,22824,23.62,Gujarat-Surat North -160
6,AARJUBI RAUF SHAH,Independent,125,0,125,0.13,Gujarat-Surat North -160
7,MOHAMMAD JUNED MEMON,Independent,56,0,56,0.06,Gujarat-Surat North -160
8,MOHAMMAD IMTIYAZ YUSUF BHAI SHAIKH,Independent,177,0,177,0.18,Gujarat-Surat North -160
9,SIRAJKHAN PATHAN,Independent,83,0,83,0.09,Gujarat-Surat North -160
10,NOTA,None of the Above,828,3,831,0.86,Gujarat-Surat North -160
1,KISHOR KANANI (KUMAR),Bharatiya Janata Party,67117,89,67206,55.13,Gujarat-Varachha Road -161
2,PYARELAL BHARTI,Bahujan Samaj Party,284,0,284,0.23,Gujarat-Varachha Road -161
3,PRAFULBHAI TOGADIYA (PAPANBHAI),Indian National Congress,2939,1,2940,2.41,Gujarat-Varachha Road -161
4,ALPESH KATHIRIYA,Aam Aadmi Party,50285,87,50372,41.32,Gujarat-Varachha Road -161
5,MAHAJAN PRATIBHABEN PANKAJBHAI,Sardar Vallabhbhai Patel Party,228,0,228,0.19,Gujarat-Varachha Road -161
6,NOTA,None of the Above,875,3,878,0.72,Gujarat-Varachha Road -161
1,PRAVINBHAI MANJIBHAI GHOGHARI,Bharatiya Janata Party,60441,52,60493,67.67,Gujarat-Karanj -162
2,BHARTI PRAKASHBHAI PATEL,Indian National Congress,2950,4,2954,3.3,Gujarat-Karanj -162
3,MANOJ SORATHIYA,Aam Aadmi Party,24438,81,24519,27.43,Gujarat-Karanj -162
4,LADUMOR MAHESHBHAI KABABHAI (AHIR),Right to Recall Party,214,4,218,0.24,Gujarat-Karanj -162
5,VAGHELA DINESH,National Maha Sabha Party,93,0,93,0.1,Gujarat-Karanj -162
6,ANWAR HAMID SHAIKH,Independent,91,0,91,0.1,Gujarat-Karanj -162
7,ARUNBHAI MANSUKHLAL PARMAR,Independent,116,0,116,0.13,Gujarat-Karanj -162
8,RAMESHBHAI PARSHOTAMBHAI BARAIYA,Independent,149,0,149,0.17,Gujarat-Karanj -162
9,NOTA,None of the Above,755,1,756,0.85,Gujarat-Karanj -162
1,Ayaz Kazi,Bahujan Samaj Party,971,1,972,0.54,Gujarat-Limbayat -163
2,Gopal D. Patil,Indian National Congress,29407,29,29436,16.44,Gujarat-Limbayat -163
3,Bharatbhai B. Patel,Communist Party of India  (Marxist),538,2,540,0.3,Gujarat-Limbayat -163
4,Sangitaben Rajendra Patil,Bharatiya Janata Party,95515,181,95696,53.44,Gujarat-Limbayat -163
5,Abdul Bashir Shaikh,All India Majlis-E-Ittehadul Muslimeen,5215,1,5216,2.91,Gujarat-Limbayat -163
6,Pankajbhai Tayade,Aam Aadmi Party,37545,142,37687,21.05,Gujarat-Limbayat -163
7,Ramzan Mansuri (Varisht Partrakar),Log Party,139,0,139,0.08,Gujarat-Limbayat -163
8,Rani Aziz Shaikh,Rashtriya Samaj Paksha,136,0,136,0.08,Gujarat-Limbayat -163
9,Ram Murat Maurya (Comrade),SOCIALIST UNITY CENTRE OF INDIA (COMMUNIST),181,1,182,0.1,Gujarat-Limbayat -163
10,Shaikh Subhan Abudulla,Samajwadi Party,249,0,249,0.14,Gujarat-Limbayat -163
11,Akram Vahidulla Ansari,Independent,242,3,245,0.14,Gujarat-Limbayat -163
12,Azim Saiyad,Independent,153,0,153,0.09,Gujarat-Limbayat -163
13,Anishaben Kureshi,Independent,868,2,870,0.49,Gujarat-Limbayat -163
14,Arun Pathak (Gabbar),Independent,139,0,139,0.08,Gujarat-Limbayat -163
15,Imrankhan Shokat Khan,Independent,279,0,279,0.16,Gujarat-Limbayat -163
16,IrfanKhan Pathan,Independent,733,0,733,0.41,Gujarat-Limbayat -163
17,Khalik Yusuf Shaikh,Independent,254,0,254,0.14,Gujarat-Limbayat -163
18,Javid Shaikh,Independent,244,0,244,0.14,Gujarat-Limbayat -163
19,Nasrinbano Shaikh,Independent,176,0,176,0.1,Gujarat-Limbayat -163
20,Nasirshaha Naththushaha,Independent,270,0,270,0.15,Gujarat-Limbayat -163
21,Patel Aamin Abdul Ghafar,Independent,147,0,147,0.08,Gujarat-Limbayat -163
22,Pathan BashirKhan,Independent,216,0,216,0.12,Gujarat-Limbayat -163
23,Faruk Khan,Independent,77,0,77,0.04,Gujarat-Limbayat -163
24,FARUKHASHA SHABBIRSHA,Independent,84,0,84,0.05,Gujarat-Limbayat -163
25,Mohammad Nafis Islam Khan,Independent,74,0,74,0.04,Gujarat-Limbayat -163
26,Mohshin Shah,Independent,60,0,60,0.03,Gujarat-Limbayat -163
27,Ramjubhai Shaikh,Independent,90,0,90,0.05,Gujarat-Limbayat -163
28,Rashid Dadamiya Shaikh,Independent,74,0,74,0.04,Gujarat-Limbayat -163
29,Raybole Panjab,Independent,144,0,144,0.08,Gujarat-Limbayat -163
30,Rekhaben Satishbhai Patel,Independent,113,0,113,0.06,Gujarat-Limbayat -163
31,Wasim Karim Shaikh,Independent,950,0,950,0.53,Gujarat-Limbayat -163
32,Vasim Shaikh,Independent,255,0,255,0.14,Gujarat-Limbayat -163
33,Sami Akhtar Isaf Mohammad Shaikh,Independent,239,0,239,0.13,Gujarat-Limbayat -163
34,Shah Aiyub,Independent,183,0,183,0.1,Gujarat-Limbayat -163
35,Shah Firoj Supadubhai,Independent,128,0,128,0.07,Gujarat-Limbayat -163
36,SHAH SAMIR SHAIKHLAL,Independent,312,0,312,0.17,Gujarat-Limbayat -163
37,Shaikh Yusuf,Independent,100,0,100,0.06,Gujarat-Limbayat -163
38,Shaikh Salman,Independent,159,0,159,0.09,Gujarat-Limbayat -163
39,Sabirabibi  Mohammad Yusuf Shaikh,Independent,269,0,269,0.15,Gujarat-Limbayat -163
40,Sayarabanu Hamid Rana,Independent,113,0,113,0.06,Gujarat-Limbayat -163
41,Saiyad Mehmud,Independent,148,0,148,0.08,Gujarat-Limbayat -163
42,Saiyad Suraiya Latif,Independent,87,0,87,0.05,Gujarat-Limbayat -163
43,Hameed Madhavsang Rana,Independent,227,0,227,0.13,Gujarat-Limbayat -163
44,Hamid Shaikh,Independent,123,0,123,0.07,Gujarat-Limbayat -163
45,NOTA,None of the Above,1057,12,1069,0.6,Gujarat-Limbayat -163
1,DHANSUKHBHAI  BHAGVATIPRASAD RAJPUT,Indian National Congress,24070,33,24103,16.19,Gujarat-Udhna -164
2,MANUBHAI M. PATEL (FOGWA),Bharatiya Janata Party,93863,136,93999,63.16,Gujarat-Udhna -164
3,SURESH MOHAN SONVANE,Bahujan Samaj Party,5420,14,5434,3.65,Gujarat-Udhna -164
4,PATHAN BADSHAHKHAN ALTAFKHAN,Bharatiya Bahujan Congress,306,0,306,0.21,Gujarat-Udhna -164
5,MAHENDRABHAI RAVANBHAI PATIL,Aam Aadmi Party,21634,107,21741,14.61,Gujarat-Udhna -164
6,ASHABEN VINODBHAI  MANGALE,Independent,475,1,476,0.32,Gujarat-Udhna -164
7,EJAZ ASLAMBHAI MISTRY,Independent,183,0,183,0.12,Gujarat-Udhna -164
8,FAIMIDA YUNUS SHAIKH,Independent,194,1,195,0.13,Gujarat-Udhna -164
9,MOHAMMAD  BALDAR SHAH,Independent,281,0,281,0.19,Gujarat-Udhna -164
10,SHAIKH IQBAL HAMID,Independent,292,1,293,0.2,Gujarat-Udhna -164
11,NOTA,None of the Above,1815,5,1820,1.22,Gujarat-Udhna -164
1,BALWANT SHANTILAL JAIN,Indian National Congress,9410,37,9447,5.81,Gujarat-Majura -165
2,RAMESHPRASAD KASHIRAM CHAMAR,Bahujan Samaj Party,902,2,904,0.56,Gujarat-Majura -165
3,HARSH RAMESH SANGHVI,Bharatiya Janata Party,132978,357,133335,81.97,Gujarat-Majura -165
4,P V S SARMA,Aam Aadmi Party,16399,261,16660,10.24,Gujarat-Majura -165
5,NOTA,None of the Above,2297,18,2315,1.42,Gujarat-Majura -165
1,AMITKUMAR BIKARAM SINGH,Bahujan Samaj Party,620,0,620,0.3,Gujarat-Katargam -166
2,VARIYA KALPESH HARJIVANBHAI,Indian National Congress,26807,33,26840,12.97,Gujarat-Katargam -166
3,VINODBHAI AMARSHIBHAI MORADIYA,Bharatiya Janata Party,120342,163,120505,58.25,Gujarat-Katargam -166
4,AMARKUMAR SURESHBHAI LAVNE,Sarvodaya Bharat Party,588,1,589,0.28,Gujarat-Katargam -166
5,GOPAL ITALIA,Aam Aadmi Party,55713,165,55878,27.01,Gujarat-Katargam -166
6,AKBAR LIYAKAT SHAHFAKIR,Independent,302,0,302,0.15,Gujarat-Katargam -166
7,BAPUBHAI NANABHAI KHALANE,Independent,288,0,288,0.14,Gujarat-Katargam -166
8,SARAKAR RAJUBHAI LAKHABHAI,Independent,318,0,318,0.15,Gujarat-Katargam -166
9,NOTA,None of the Above,1521,8,1529,0.74,Gujarat-Katargam -166
1,PURNESH MODI,Bharatiya Janata Party,122464,517,122981,75.73,Gujarat-Surat West -167
2,VIMAL RAJU UTTPURE,Bahujan Samaj Party,452,2,454,0.28,Gujarat-Surat West -167
3,SANJAY R. SHAH (PATVA),Indian National Congress,18607,62,18669,11.5,Gujarat-Surat West -167
4,MOHAMMED ZAKIR NIZAMUDDIN SHAIKH,Samajwadi Party,300,1,301,0.19,Gujarat-Surat West -167
5,MOXESH RAMESHCHANDRA SANGHAVI,Aam Aadmi Party,16780,175,16955,10.44,Gujarat-Surat West -167
6,AMISH NARAYANBHAI CHUNAWALA,Independent,141,0,141,0.09,Gujarat-Surat West -167
7,KAMALSHAH FAKIR,Independent,84,1,85,0.05,Gujarat-Surat West -167
8,FARZAN ALLARAKHA MEMAN,Independent,115,0,115,0.07,Gujarat-Surat West -167
9,MOHAMMAD UMARJI KHADAKIWALA,Independent,126,0,126,0.08,Gujarat-Surat West -167
10,MOHAMAD ASFAQ IQBAL SHEKH,Independent,130,0,130,0.08,Gujarat-Surat West -167
11,NOTA,None of the Above,2415,26,2441,1.5,Gujarat-Surat West -167
1,KANTILAL NANUBHAI PATEL,Indian National Congress,25761,79,25840,8.01,Gujarat-Choryasi -168
2,MALKHAN RAMKISHOR VARMA,Bahujan Samaj Party,2058,3,2061,0.64,Gujarat-Choryasi -168
3,SANDIP DESAI,Bharatiya Janata Party,235374,659,236033,73.12,Gujarat-Choryasi -168
4,CHAVADA HITESHBHAI,Sarvodaya Bharat Party,1060,0,1060,0.33,Gujarat-Choryasi -168
5,JUBER KASHIM ANSARI,Samajwadi Party,774,0,774,0.24,Gujarat-Choryasi -168
6,PRAKASHBHAI VINODBHAI CONTRACTOR,Aam Aadmi Party,49245,370,49615,15.37,Gujarat-Choryasi -168
7,PRAJAPATI ROSHANLAL PYARELAL,National Maha Sabha Party,621,0,621,0.19,Gujarat-Choryasi -168
8,MANSURI AAISHA,Log Party,228,0,228,0.07,Gujarat-Choryasi -168
9,RABARI MOTIBHAI VARSHIBHAI,Rashtriya Samaj Paksha,501,0,501,0.16,Gujarat-Choryasi -168
10,VASAVA VINODKUMAR,Gana Suraksha Party,538,3,541,0.17,Gujarat-Choryasi -168
11,ARUN PATHAK (GABBAR),Independent,315,3,318,0.1,Gujarat-Choryasi -168
12,SHEKH SHERU,Independent,514,1,515,0.16,Gujarat-Choryasi -168
13,SATTAR PINJARI,Independent,509,0,509,0.16,Gujarat-Choryasi -168
14,NOTA,None of the Above,4140,29,4169,1.29,Gujarat-Choryasi -168
1,ISHVARBHAI ALIAS ANILBHAI RAMANBHAI PARMAR,Bharatiya Janata Party,118140,387,118527,66.14,Gujarat-Bardoli -169
2,PANNABEN ANILBHAI PATEL,Indian National Congress,28478,101,28579,15.95,Gujarat-Bardoli -169
3,SUSHILABEN RAMESHBHAI WAGH,Bahujan Samaj Party,1092,1,1093,0.61,Gujarat-Bardoli -169
4,RAJENDRAPRASAD SOLANKI ALIAS RAJU MORTHANA,Aam Aadmi Party,24445,265,24710,13.79,Gujarat-Bardoli -169
5,RATHOD DINESHKUMAR LALLUBHAI,Independent,2070,4,2074,1.16,Gujarat-Bardoli -169
6,NOTA,None of the Above,4203,8,4211,2.35,Gujarat-Bardoli -169
1,GARASIYA HEMANGINI DIPAKKUMAR,Indian National Congress,49598,277,49875,29.34,Gujarat-Mahuva -170
2,MOHANBHAI DHANJIBHAI DHODIYA,Bharatiya Janata Party,81143,240,81383,47.88,Gujarat-Mahuva -170
3,KUNJANKUMAR RAMESHCHANDRA PATEL,Aam Aadmi Party,34924,667,35591,20.94,Gujarat-Mahuva -170
4,NOTA,None of the Above,3120,11,3131,1.84,Gujarat-Mahuva -170
1,KOKANI MOHANBHAI DHEDABHAI,Bharatiya Janata Party,69024,609,69633,40.67,Gujarat-Vyara -171
2,GAMIT PUNABHAI DHEDABHAI,Indian National Congress,45224,680,45904,26.81,Gujarat-Vyara -171
3,RAKESHBHAI SURESHBHAI GAMIT,Bahujan Samaj Party,1281,10,1291,0.75,Gujarat-Vyara -171
4,BIPINCHANDRA KHUSHALBHAI CHAUDHARI,Aam Aadmi Party,46264,1249,47513,27.75,Gujarat-Vyara -171
5,SUNILBHAI NAGAJIBHAI GAMIT,Bhartiya Tribal Party,1113,23,1136,0.66,Gujarat-Vyara -171
6,UMEDBHAI BHIMSINGBHAI GAMIT,Independent,738,12,750,0.44,Gujarat-Vyara -171
7,JIMIKUMAR RAJENBHAI PATEL,Independent,1196,22,1218,0.71,Gujarat-Vyara -171
8,NOTA,None of the Above,3756,23,3779,2.21,Gujarat-Vyara -171
1,DR.JAYRAMBHAI CHEMABHAI GAMIT,Bharatiya Janata Party,97109,352,97461,43.79,Gujarat-Nizar -172
2,SUNILBHAI RATANJIBHAI GAMIT,Indian National Congress,73882,419,74301,33.39,Gujarat-Nizar -172
3,ARVINDBHAI SINGABHAI GAMIT,Aam Aadmi Party,35025,756,35781,16.08,Gujarat-Nizar -172
4,SAMIRBHAI JANAKBHAI NAIK,Bhartiya Tribal Party,3592,15,3607,1.62,Gujarat-Nizar -172
5,MANISHBHAI PRAKASHBHAI VASAVA,Independent,5265,11,5276,2.37,Gujarat-Nizar -172
6,VINABHAI BABLABHAI GAMIT,Independent,1663,1,1664,0.75,Gujarat-Nizar -172
7,NOTA,None of the Above,4455,10,4465,2.01,Gujarat-Nizar -172
1,PATEL MUKESHBHAI CHANDARBHAI,Indian National Congress,42436,423,42859,32.58,Gujarat-Dangs -173
2,VIJAYBHAI RAMESHBHAI PATEL,Bharatiya Janata Party,62153,380,62533,47.54,Gujarat-Dangs -173
3,SANGITABEN MAHESHBHAI AHIRE,Bahujan Samaj Party,1459,9,1468,1.12,Gujarat-Dangs -173
4,GAMIT SUNILBHAI CHANDUBHAI,Aam Aadmi Party,20278,544,20822,15.83,Gujarat-Dangs -173
5,NILESHBHAI SHIVAJIBHAI ZAMBARE,Bhartiya Tribal Party,844,3,847,0.64,Gujarat-Dangs -173
6,AESTARBEN KESHARBHAI PAWAR,Independent,1100,3,1103,0.84,Gujarat-Dangs -173
7,NOTA,None of the Above,1902,8,1910,1.45,Gujarat-Dangs -173
1,R.C.PATEL,Bharatiya Janata Party,105921,323,106244,66.83,Gujarat-Jalalpore -174
2,RANJIT (MUNNABHAI) PANCHAL,Indian National Congress,37400,145,37545,23.62,Gujarat-Jalalpore -174
3,NAUSRKA MAHAMMAD SHAUKATALI,SOCIAL DEMOCRATIC PARTY OF INDIA,1241,0,1241,0.78,Gujarat-Jalalpore -174
4,PRADIPKUMAR (BANKWALA),Aam Aadmi Party,10167,229,10396,6.54,Gujarat-Jalalpore -174
5,NOTA,None of the Above,3534,15,3549,2.23,Gujarat-Jalalpore -174
1,Dipak Barot,Indian National Congress,34422,140,34562,20.91,Gujarat-Navsari -175
2,Desai Rakesh Gunvantbhai,Bharatiya Janata Party,106559,316,106875,64.65,Gujarat-Navsari -175
3,Mahendrakumar Solanki (Rakeshkumar),Bahujan Samaj Party,894,1,895,0.54,Gujarat-Navsari -175
4,Upeshkumar Mohanbhai Patel,Aam Aadmi Party,18131,304,18435,11.15,Gujarat-Navsari -175
5,Kalpanaben Percy Munshi,Independent,652,3,655,0.4,Gujarat-Navsari -175
6,Govindbhai Laxmanbhai Rathod,Independent,817,1,818,0.49,Gujarat-Navsari -175
7,NOTA,None of the Above,3048,16,3064,1.85,Gujarat-Navsari -175
1,Ashokbhai Lallubhai Patel (Karate),Indian National Congress,37702,248,37950,18.01,Gujarat-Gandevi -176
2,Nareshbhai  Maganbhai Patel,Bharatiya Janata Party,130531,585,131116,62.24,Gujarat-Gandevi -176
3,Pankajbhai Lallubhai Patel,Aam Aadmi Party,37248,570,37818,17.95,Gujarat-Gandevi -176
4,NOTA,None of the Above,3758,17,3775,1.79,Gujarat-Gandevi -176
1,ANANTKUMAR HASMUKHBHAI PATEL,Indian National Congress,122909,1568,124477,52.57,Gujarat-Bansda -177
2,PIYUSHKUMAR KANTILAL PATEL,Bharatiya Janata Party,88967,477,89444,37.78,Gujarat-Bansda -177
3,MANAKBHAI JATRUBHAI SANAKAR,Bahujan Samaj Party,1806,1,1807,0.76,Gujarat-Bansda -177
4,ALPESHKUMAR CHHOTUBHAI PATEL,Bahujan Republican  Socialist Party,1055,3,1058,0.45,Gujarat-Bansda -177
5,PANKAJBHAI CHANDUBHAI PATEL,Aam Aadmi Party,15848,330,16178,6.83,Gujarat-Bansda -177
6,NOTA,None of the Above,3795,8,3803,1.61,Gujarat-Bansda -177
1,Arvind Chhotubhai Patel,Bharatiya Janata Party,83250,294,83544,42.24,Gujarat-Dharampur -178
2,Kishanbhai V. Patel,Indian National Congress,33409,98,33507,16.94,Gujarat-Dharampur -178
3,Ratilal Vajirbhai Thakrya,Bahujan Samaj Party,1459,2,1461,0.74,Gujarat-Dharampur -178
4,Kamleshbhai Ghelabhai Patel,Aam Aadmi Party,49544,673,50217,25.39,Gujarat-Dharampur -178
5,Barat Anandbhai Dubiyabhai,Communist Party of India  (Marxist-Leninist)  (Liberation),890,0,890,0.45,Gujarat-Dharampur -178
6,Sureshbhai Ballubhai Patel,Bhartiya Tribal Party,881,1,882,0.45,Gujarat-Dharampur -178
7,Kalpesh  Patel,Independent,19410,80,19490,9.85,Gujarat-Dharampur -178
8,Ganvit Kalpeshbhai Maganbhai,Independent,1674,3,1677,0.85,Gujarat-Dharampur -178
9,Janubhai Dhakalbhai Kakad,Independent,1944,1,1945,0.98,Gujarat-Dharampur -178
10,NOTA,None of the Above,4178,11,4189,2.12,Gujarat-Dharampur -178
1,KAMALBHAI SHANTILAL PATEL,Indian National Congress,21404,118,21522,12.23,Gujarat-Valsad -179
2,BHARATBHAI KIKUBHAI PATEL,Bharatiya Janata Party,125809,514,126323,71.75,Gujarat-Valsad -179
3,KAMLESHBHAI  BHARATBHAI  YOGI,Samajwadi Party,804,3,807,0.46,Gujarat-Valsad -179
4,MAHESH VINAYAKRAY ACHARYA,Praja Vijay Paksh,781,38,819,0.47,Gujarat-Valsad -179
5,RAJESHBHAI THAKORBHAI GOHIL,Bharatiya Republican Paksha,333,2,335,0.19,Gujarat-Valsad -179
6,RAJESHBHAI MANGUBHAI PATEL,Aam Aadmi Party,22067,480,22547,12.81,Gujarat-Valsad -179
7,HEMANTKUMAR GOPALBHAI TANDEL,Rashtriya Samaj Paksha,877,3,880,0.5,Gujarat-Valsad -179
8,NOTA,None of the Above,2800,15,2815,1.6,Gujarat-Valsad -179
1,KANUBHAI MOHANLAL DESAI,Bharatiya Janata Party,121743,225,121968,73.43,Gujarat-Pardi -180
2,JAYSHREEBEN PATEL,Indian National Congress,24761,43,24804,14.93,Gujarat-Pardi -180
3,KETANBHAI KISHORBHAI PATEL,Aam Aadmi Party,15173,133,15306,9.22,Gujarat-Pardi -180
4,SANJAYBHAI PARSOTTAMBHAI PARMAR,Rashtriya Samaj Paksha,452,2,454,0.27,Gujarat-Pardi -180
5,PATEL NAVINKUMAR SHANKARBHAI,Independent,458,2,460,0.28,Gujarat-Pardi -180
6,PRAVINKUMAR BHOLAPRASAD SINGH,Independent,784,0,784,0.47,Gujarat-Pardi -180
7,NOTA,None of the Above,2314,2,2316,1.39,Gujarat-Pardi -180
1,Jitubhai Harjibhai Chaudhari,Bharatiya Janata Party,90667,332,90999,42.64,Gujarat-Kaprada -181
2,Vasantbhai Barjulbhai Patel,Indian National Congress,57863,168,58031,27.19,Gujarat-Kaprada -181
3,Vaichandbhai Lallubhai Patel,Bahujan Samaj Party,2538,7,2545,1.19,Gujarat-Kaprada -181
4,Gurav Kamleshbhai Shravanbhai,Communist Party of India  (Marxist-Leninist)  (Liberation),1460,4,1464,0.69,Gujarat-Kaprada -181
5,Jayendrabhai Laxmanbhai Ganvit,Aam Aadmi Party,52611,557,53168,24.92,Gujarat-Kaprada -181
6,Subhashbhai Radkabhai Patel,Rashtriya Samaj Paksha,1191,8,1199,0.56,Gujarat-Kaprada -181
7,Gaurangkumar Rameshbhai Patel,Independent,1962,2,1964,0.92,Gujarat-Kaprada -181
8,NOTA,None of the Above,4016,4,4020,1.88,Gujarat-Kaprada -181
1,NARESHBHAI VAJIRBHAI VADVI,Indian National Congress,45230,72,45302,26.15,Gujarat-Umbergaon -182
2,PATKAR RAMANLAL NANUBHAI,Bharatiya Janata Party,109896,192,110088,63.55,Gujarat-Umbergaon -182
3,BOCHAL HASMUKHBHAI RAMANBHAI,Communist Party of India  (Marxist),1777,1,1778,1.03,Gujarat-Umbergaon -182
4,ASHOKBHAI MOHANBHAI  PATEL,Aam Aadmi Party,10553,123,10676,6.16,Gujarat-Umbergaon -182
5,MOHANBHAI RAVIYABHAI KOHKERIYA,Communist Party of India  (Marxist-Leninist)  (Liberation),762,2,764,0.44,Gujarat-Umbergaon -182
6,VAGHAT RAVINDRABHAI SOMABHAI,Bhartiya Tribal Party,1856,2,1858,1.07,Gujarat-Umbergaon -182
7,NOTA,None of the Above,2768,4,2772,1.6,Gujarat-Umbergaon -182
